,GAME_ID,home_away_home,TEAM_ID_home,TEAM_ABBREVIATION_home,PTS_home,home_away_away,TEAM_ID_away,TEAM_ABBREVIATION_away,PTS_away,home_margin,away_margin,home_id,away_id,home_lineup,away_lineup,was_home_correct
0,0021400001,home,1610612740,NOP,101,away,1610612753,ORL,84,17,-17,1610612740,1610612753,"(201600, 201569, 201936, 203076, 201950)","(202696, 202699, 203124, 203901, 203095)",False
1,0021400002,home,1610612759,SAS,101,away,1610612742,DAL,100,-1,1,1610612759,1610612742,"(2225, 201980, 2588, 201158, 1495)","(2749, 101145, 1717, 202718, 2199)",True
2,0021400003,home,1610612747,LAL,90,away,1610612745,HOU,108,18,-18,1610612747,1610612745,"(977, 202325, 201941, 2430, 202391)","(201976, 2730, 2772, 203093, 201935)",True
3,0021400004,home,1610612766,CHA,108,away,1610612749,MIL,106,2,-2,1610612766,1610612749,"(2744, 202689, 202362, 101107, 203077)","(202688, 202336, 201162, 203114, 203953)",False
4,0021400005,home,1610612754,IND,103,away,1610612755,PHI,91,12,-12,1610612754,1610612755,"(101139, 2449, 202388, 201579, 203524)","(203100, 203457, 203138, 203187, 203156)",False
5,0021400006,home,1610612738,BOS,121,away,1610612751,BKN,105,-16,16,1610612738,1610612751,"(203096, 201145, 203482, 202340, 200765)","(101114, 2207, 708, 203486, 202711)",True
6,0021400007,home,1610612748,MIA,107,away,1610612764,WAS,95,12,-12,1610612748,1610612764,"(2736, 202708, 2547, 2548, 200761)","(2400, 101162, 202322, 202066, 1718)",False
7,0021400008,home,1610612761,TOR,109,away,1610612737,ATL,102,-7,7,1610612761,1610612737,"(200768, 101161, 203082, 202685, 201942)","(201952, 201960, 2594, 200794, 201143)",True
8,0021400009,home,1610612763,MEM,105,away,1610612750,MIN,101,4,-4,1610612763,1610612750,"(2216, 201584, 2754, 201144, 201188)","(201152, 203952, 201147, 201593, 201937)",False
9,0021400010,home,1610612752,NYK,80,away,1610612741,CHI,104,24,-24,1610612752,1610612741,"(202697, 2546, 203499, 2405, 2223)","(2200, 2399, 201565, 2550, 201149)",True
10,0021400011,home,1610612743,DEN,89,away,1610612765,DET,79,10,-10,1610612743,1610612765,"(201568, 201951, 202389, 202702, 201167)","(202713, 2746, 203083, 203484, 201943)",False
11,0021400012,home,1610612762,UTA,93,away,1610612745,HOU,104,11,-11,1610612762,1610612745,"(203504, 202324, 202330, 202683, 202692)","(201976, 2730, 2772, 203093, 201935)",True
12,0021400013,home,1610612756,PHX,119,away,1610612747,LAL,99,-20,20,1610612756,1610612747,"(201609, 202339, 202693, 202694, 203101)","(977, 201941, 202325, 2430, 202391)",True
13,0021400014,home,1610612758,SAC,77,away,1610612744,GSW,95,18,-18,1610612758,1610612744,"(200752, 201954, 202326, 201574, 203463)","(201939, 101106, 202691, 203084, 203110)",True
14,0021400015,home,1610612757,POR,106,away,1610612760,OKC,89,-17,17,1610612757,1610612760,"(203081, 200746, 202083, 201587, 201577)","(203500, 201586, 203460, 201566, 203103)",True
15,0021400016,home,1610612753,ORL,98,away,1610612764,WAS,105,-7,7,1610612753,1610612764,"(202696, 101112, 202699, 203901, 203095)","(101162, 2403, 202322, 202066, 1718)",False
16,0021400017,home,1610612750,MIN,97,away,1610612765,DET,91,-6,6,1610612750,1610612765,"(201152, 203952, 201147, 201593, 201937)","(202713, 2746, 203083, 203484, 201943)",True
17,0021400018,home,1610612739,CLE,90,away,1610612752,NYK,95,-5,5,1610612739,1610612752,"(2544, 2760, 201567, 202681, 203079)","(203112, 202697, 2546, 203499, 2223)",False
18,0021400019,home,1610612742,DAL,120,away,1610612762,UTA,102,18,-18,1610612742,1610612762,"(2749, 101145, 1717, 202718, 2199)","(203504, 202324, 202330, 202683, 202692)",False
19,0021400020,home,1610612746,LAC,93,away,1610612760,OKC,90,3,-3,1610612746,1610612760,"(2440, 200755, 101108, 201933, 201599)","(203500, 201586, 203460, 201566, 203103)",False
20,0021400021,home,1610612754,IND,89,away,1610612763,MEM,97,-8,8,1610612754,1610612763,"(101139, 2449, 201579, 202388, 203524)","(2216, 201584, 2754, 201144, 201188)",False
21,0021400022,home,1610612741,CHI,108,away,1610612739,CLE,114,-6,6,1610612741,1610612739,"(2200, 2399, 201565, 2550, 201149)","(2760, 2544, 201567, 202681, 203079)",False
22,0021400023,home,1610612749,MIL,93,away,1610612755,PHI,81,12,-12,1610612749,1610612755,"(202688, 203953, 201162, 202336, 203114)","(203100, 203457, 203138, 203187, 203156)",False
23,0021400024,home,1610612756,PHX,94,away,1610612759,SAS,89,5,-5,1610612756,1610612759,"(201609, 202339, 202693, 202694, 203101)","(2225, 1495, 201948, 201980, 202695)",False
24,0021400025,home,1610612758,SAC,103,away,1610612757,POR,94,-9,9,1610612758,1610612757,"(200752, 201954, 202326, 201574, 203463)","(203081, 200746, 202083, 201587, 201577)",True
25,0021400026,home,1610612747,LAL,111,away,1610612746,LAC,118,7,-7,1610612747,1610612746,"(977, 202391, 202325, 2430, 201941)","(2440, 200755, 101108, 201933, 201599)",True
26,0021400027,home,1610612740,NOP,104,away,1610612742,DAL,109,5,-5,1610612740,1610612742,"(201600, 201569, 201936, 203076, 201950)","(2749, 101145, 1717, 202718, 2199)",True
27,0021400028,home,1610612766,CHA,69,away,1610612763,MEM,71,-2,2,1610612766,1610612763,"(2744, 202689, 202362, 101107, 203077)","(2216, 201144, 2754, 2419, 201188)",False
28,0021400029,home,1610612753,ORL,95,away,1610612761,TOR,108,-13,13,1610612753,1610612761,"(202696, 101112, 202699, 203901, 203095)","(200768, 101161, 203082, 202685, 201942)",False
29,0021400030,home,1610612755,PHI,96,away,1610612748,MIA,114,18,-18,1610612755,1610612748,"(201601, 203138, 203100, 203156, 203457)","(2736, 200761, 202708, 2547, 2548)",True
30,0021400031,home,1610612764,WAS,108,away,1610612749,MIL,97,-11,11,1610612764,1610612749,"(101162, 2403, 202322, 202066, 1718)","(202688, 202336, 201162, 203114, 203953)",True
31,0021400032,home,1610612737,ATL,102,away,1610612754,IND,92,10,-10,1610612737,1610612754,"(201952, 201960, 2594, 200794, 201143)","(101139, 2449, 202388, 201579, 203524)",False
32,0021400033,home,1610612765,DET,90,away,1610612751,BKN,102,12,-12,1610612765,1610612751,"(202713, 2746, 203083, 203484, 201943)","(101114, 2207, 708, 203486, 202711)",True
33,0021400034,home,1610612745,HOU,104,away,1610612738,BOS,90,-14,14,1610612745,1610612738,"(2730, 2772, 203477, 203093, 201935)","(203096, 201145, 203482, 202340, 200765)",True
34,0021400035,home,1610612750,MIN,105,away,1610612741,CHI,106,1,-1,1610612750,1610612741,"(201152, 203952, 2755, 201593, 201937)","(2200, 2399, 202710, 2550, 201149)",True
35,0021400036,home,1610612760,OKC,102,away,1610612743,DEN,91,-11,11,1610612760,1610612743,"(203500, 201586, 203460, 2742, 203103)","(201568, 201951, 202389, 202702, 201167)",True
36,0021400037,home,1610612762,UTA,118,away,1610612756,PHX,91,-27,27,1610612762,1610612756,"(203504, 202324, 202330, 202683, 202692)","(201609, 202339, 202693, 202694, 203101)",True
37,0021400038,home,1610612744,GSW,127,away,1610612747,LAL,104,23,-23,1610612744,1610612747,"(201939, 101106, 202691, 203084, 203110)","(977, 201941, 202325, 2430, 202391)",False
38,0021400039,home,1610612746,LAC,92,away,1610612758,SAC,98,-6,6,1610612746,1610612758,"(2440, 200755, 101108, 201933, 201599)","(200752, 201954, 202326, 201574, 203463)",False
39,0021400040,home,1610612748,MIA,107,away,1610612761,TOR,102,5,-5,1610612748,1610612761,"(2736, 202708, 2547, 2548, 200761)","(200768, 203082, 202685, 201942, 202335)",False
40,0021400041,home,1610612752,NYK,96,away,1610612766,CHA,93,-3,3,1610612752,1610612766,"(203112, 202697, 2546, 203499, 2223)","(2744, 202689, 202362, 101107, 203077)",True
41,0021400042,home,1610612757,POR,90,away,1610612744,GSW,95,5,-5,1610612757,1610612744,"(203081, 200746, 202083, 201587, 201577)","(202691, 101106, 201939, 203084, 203110)",True
42,0021400043,home,1610612755,PHI,93,away,1610612745,HOU,104,11,-11,1610612755,1610612745,"(201601, 203138, 203100, 203561, 203457)","(2730, 2772, 203477, 203093, 201935)",True
43,0021400044,home,1610612751,BKN,116,away,1610612760,OKC,85,31,-31,1610612751,1610612760,"(708, 101114, 2207, 201572, 202711)","(202704, 203460, 201586, 203500, 203103)",False
44,0021400045,home,1610612763,MEM,93,away,1610612740,NOP,81,12,-12,1610612763,1610612740,"(2216, 201144, 2754, 2419, 201188)","(201600, 201569, 201936, 203076, 201950)",False
45,0021400046,home,1610612742,DAL,118,away,1610612738,BOS,113,-5,5,1610612742,1610612738,"(101145, 2199, 2749, 202718, 1717)","(203096, 201145, 203482, 202340, 200765)",True
46,0021400047,home,1610612743,DEN,105,away,1610612758,SAC,110,-5,5,1610612743,1610612758,"(201163, 201951, 202389, 202702, 201167)","(200752, 201954, 202326, 201574, 203463)",False
47,0021400048,home,1610612746,LAC,107,away,1610612762,UTA,101,6,-6,1610612746,1610612762,"(2440, 200755, 101108, 201933, 201599)","(203504, 202324, 202330, 202683, 202692)",False
48,0021400049,home,1610612754,IND,81,away,1610612749,MIL,87,-6,6,1610612754,1610612749,"(101139, 2449, 202388, 201579, 203524)","(202688, 202336, 201162, 101141, 203953)",False
49,0021400050,home,1610612748,MIA,91,away,1610612745,HOU,108,17,-17,1610612748,1610612745,"(2736, 200761, 202708, 2547, 2548)","(201976, 2772, 2730, 202700, 201935)",True
50,0021400051,home,1610612752,NYK,83,away,1610612764,WAS,98,-15,15,1610612752,1610612764,"(202697, 2546, 203499, 2405, 2223)","(101162, 2403, 202322, 202066, 1718)",False
51,0021400052,home,1610612761,TOR,100,away,1610612760,OKC,88,-12,12,1610612761,1610612760,"(200768, 203082, 202685, 201942, 202335)","(202704, 202498, 203500, 201586, 203103)",True
52,0021400053,home,1610612741,CHI,98,away,1610612753,ORL,90,8,-8,1610612741,1610612753,"(2200, 2399, 202710, 2550, 201959)","(202696, 101112, 202699, 203901, 203095)",False
53,0021400054,home,1610612740,NOP,100,away,1610612766,CHA,91,-9,9,1610612740,1610612766,"(201600, 201569, 201936, 203076, 201950)","(2744, 202689, 202362, 101107, 201945)",True
54,0021400055,home,1610612757,POR,101,away,1610612739,CLE,82,-19,19,1610612757,1610612739,"(203081, 200746, 202083, 201587, 201577)","(2760, 2544, 201567, 202681, 203079)",True
55,0021400056,home,1610612747,LAL,106,away,1610612756,PHX,112,-6,6,1610612747,1610612756,"(977, 202325, 201941, 2430, 202391)","(201609, 202339, 202693, 202694, 203101)",False
56,0021400057,home,1610612766,CHA,96,away,1610612748,MIA,89,7,-7,1610612766,1610612748,"(2744, 202689, 202362, 101107, 201945)","(2736, 200761, 202708, 2547, 2548)",False
57,0021400058,home,1610612755,PHI,89,away,1610612753,ORL,91,2,-2,1610612755,1610612753,"(201601, 203138, 203100, 203561, 203457)","(202696, 101112, 202699, 203901, 203095)",True
58,0021400059,home,1610612738,BOS,107,away,1610612761,TOR,110,-3,3,1610612738,1610612761,"(203096, 201145, 203482, 202340, 200765)","(200768, 203082, 201946, 201942, 202335)",False
59,0021400060,home,1610612751,BKN,91,away,1610612750,MIN,98,-7,7,1610612751,1610612750,"(708, 101114, 2207, 201572, 202711)","(201152, 201593, 201937, 2755, 203952)",False
60,0021400061,home,1610612765,DET,98,away,1610612752,NYK,95,3,-3,1610612765,1610612752,"(202328, 2746, 203083, 203484, 201943)","(201160, 202697, 2546, 203499, 2223)",False
61,0021400062,home,1610612749,MIL,86,away,1610612741,CHI,95,9,-9,1610612749,1610612741,"(202688, 202336, 201162, 101141, 203953)","(2200, 2399, 201565, 202710, 201959)",True
62,0021400063,home,1610612764,WAS,96,away,1610612754,IND,94,-2,2,1610612764,1610612754,"(101162, 2403, 202322, 202066, 1718)","(101139, 2449, 202388, 201579, 203524)",True
63,0021400064,home,1610612759,SAS,94,away,1610612737,ATL,92,-2,2,1610612759,1610612737,"(201168, 2225, 1495, 201980, 202695)","(201952, 201960, 2594, 200794, 201143)",True
64,0021400065,home,1610612756,PHX,91,away,1610612763,MEM,102,11,-11,1610612756,1610612763,"(201609, 202339, 202693, 202694, 203101)","(2216, 201584, 2754, 201144, 201188)",True
65,0021400066,home,1610612762,UTA,102,away,1610612739,CLE,100,-2,2,1610612762,1610612739,"(203504, 202324, 202330, 202683, 202692)","(2760, 2544, 1890, 201567, 202681)",True
66,0021400067,home,1610612758,SAC,131,away,1610612743,DEN,109,-22,22,1610612758,1610612743,"(200752, 201954, 202326, 201574, 203463)","(201163, 201951, 202389, 202702, 201167)",True
67,0021400068,home,1610612744,GSW,121,away,1610612746,LAC,104,17,-17,1610612744,1610612746,"(201939, 101106, 202691, 203084, 203110)","(2440, 200755, 101108, 201933, 201599)",False
68,0021400069,home,1610612745,HOU,98,away,1610612759,SAS,81,17,-17,1610612745,1610612759,"(2772, 2730, 202700, 203477, 201935)","(2225, 201980, 2588, 203382, 202695)",False
69,0021400070,home,1610612757,POR,108,away,1610612742,DAL,87,-21,21,1610612757,1610612742,"(201577, 200746, 202083, 201587, 203081)","(2749, 101145, 1717, 202718, 2199)",True
70,0021400071,home,1610612766,CHA,122,away,1610612737,ATL,119,-3,3,1610612766,1610612737,"(2744, 202689, 202362, 101107, 203077)","(201952, 201960, 2594, 200794, 201143)",True
71,0021400072,home,1610612753,ORL,112,away,1610612750,MIN,103,-9,9,1610612753,1610612750,"(202696, 101112, 202699, 203901, 203095)","(201152, 203952, 2755, 201593, 201937)",True
72,0021400073,home,1610612755,PHI,115,away,1610612741,CHI,118,3,-3,1610612755,1610612741,"(203960, 201601, 203138, 203156, 203100)","(2200, 2399, 202710, 2550, 201149)",True
73,0021400074,home,1610612738,BOS,101,away,1610612754,IND,98,3,-3,1610612738,1610612754,"(203096, 201145, 203482, 202340, 200765)","(2449, 202388, 201579, 203524, 203142)",False
74,0021400075,home,1610612751,BKN,110,away,1610612752,NYK,99,11,-11,1610612751,1610612752,"(201572, 101114, 2207, 708, 202711)","(201160, 202697, 2546, 203501, 2223)",False
75,0021400076,home,1610612765,DET,98,away,1610612749,MIL,95,3,-3,1610612765,1610612749,"(202328, 2746, 203083, 203484, 201943)","(202688, 202336, 101141, 203953, 203088)",False
76,0021400077,home,1610612761,TOR,103,away,1610612764,WAS,84,19,-19,1610612761,1610612764,"(200768, 101161, 203082, 202685, 201942)","(101162, 2403, 202066, 202322, 1718)",False
77,0021400078,home,1610612760,OKC,89,away,1610612763,MEM,91,2,-2,1610612760,1610612763,"(202704, 202498, 203500, 201586, 203087)","(2216, 201584, 2754, 201144, 201188)",True
78,0021400079,home,1610612756,PHX,112,away,1610612758,SAC,114,-2,2,1610612756,1610612758,"(201609, 202339, 202693, 202694, 203101)","(200752, 201954, 202326, 201574, 203463)",False
79,0021400080,home,1610612762,UTA,82,away,1610612742,DAL,105,23,-23,1610612762,1610612742,"(203504, 202324, 202330, 202683, 202692)","(2749, 101145, 1717, 202718, 2199)",True
80,0021400081,home,1610612743,DEN,101,away,1610612739,CLE,110,9,-9,1610612743,1610612739,"(202389, 201163, 202702, 101126, 201167)","(2760, 2544, 1890, 201567, 202681)",True
81,0021400082,home,1610612746,LAC,106,away,1610612757,POR,102,4,-4,1610612746,1610612757,"(201599, 200755, 101108, 201933, 2037)","(203081, 200746, 202083, 201587, 201577)",False
82,0021400083,home,1610612754,IND,90,away,1610612764,WAS,97,-7,7,1610612754,1610612764,"(2449, 202388, 201579, 203524, 203142)","(101162, 2403, 202322, 202066, 1718)",False
83,0021400084,home,1610612737,ATL,103,away,1610612752,NYK,96,7,-7,1610612737,1610612752,"(201952, 201960, 2594, 200794, 201143)","(202697, 2546, 203499, 203501, 2223)",False
84,0021400085,home,1610612748,MIA,102,away,1610612750,MIN,92,10,-10,1610612748,1610612750,"(2736, 200761, 202708, 2547, 2548)","(201152, 203952, 2755, 203897, 201593)",False
85,0021400086,home,1610612741,CHI,101,away,1610612738,BOS,106,5,-5,1610612741,1610612738,"(2200, 2399, 2550, 202710, 201149)","(203096, 201145, 203482, 202323, 202340)",True
86,0021400087,home,1610612745,HOU,87,away,1610612744,GSW,98,11,-11,1610612745,1610612744,"(204028, 203123, 2772, 203477, 201935)","(201939, 101106, 202691, 203084, 203110)",True
87,0021400088,home,1610612749,MIL,93,away,1610612763,MEM,92,-1,1,1610612749,1610612763,"(202688, 202336, 201162, 101141, 203953)","(2216, 201584, 2754, 201144, 201188)",True
88,0021400089,home,1610612759,SAS,99,away,1610612740,NOP,100,1,-1,1610612759,1610612740,"(2225, 1495, 2564, 201980, 202695)","(201600, 201569, 201936, 201950, 203076)",True
89,0021400090,home,1610612751,BKN,104,away,1610612753,ORL,96,8,-8,1610612751,1610612753,"(201572, 101114, 2207, 708, 202711)","(202696, 101112, 202699, 203901, 203095)",False
90,0021400091,home,1610612765,DET,96,away,1610612762,UTA,97,-1,1,1610612765,1610612762,"(202328, 2746, 203083, 203484, 201943)","(203504, 202324, 202330, 202683, 202692)",False
91,0021400092,home,1610612760,OKC,101,away,1610612758,SAC,93,8,-8,1610612760,1610612758,"(202704, 202498, 203500, 201586, 203087)","(200752, 201954, 202326, 201574, 203463)",False
92,0021400093,home,1610612761,TOR,120,away,1610612755,PHI,88,-32,32,1610612761,1610612755,"(200768, 101161, 203082, 202685, 201942)","(203960, 201601, 203138, 203156, 203100)",True
93,0021400094,home,1610612742,DAL,96,away,1610612748,MIA,105,-9,9,1610612742,1610612748,"(2749, 101145, 1717, 202718, 2199)","(2736, 200761, 202708, 2547, 2548)",False
94,0021400095,home,1610612756,PHX,107,away,1610612744,GSW,95,-12,12,1610612756,1610612744,"(201609, 202339, 202693, 202694, 203101)","(201939, 101106, 2571, 203084, 203110)",True
95,0021400096,home,1610612757,POR,116,away,1610612743,DEN,100,-16,16,1610612757,1610612743,"(201577, 200746, 202083, 201587, 203081)","(201163, 201951, 202389, 202702, 201167)",True
96,0021400097,home,1610612747,LAL,107,away,1610612766,CHA,92,-15,15,1610612747,1610612766,"(977, 202325, 201941, 2430, 202391)","(2744, 202689, 202362, 101107, 203077)",True
97,0021400098,home,1610612739,CLE,118,away,1610612740,NOP,111,7,-7,1610612739,1610612740,"(2760, 2544, 1890, 201567, 202681)","(201600, 201569, 201936, 203076, 201950)",False
98,0021400099,home,1610612754,IND,97,away,1610612762,UTA,86,11,-11,1610612754,1610612762,"(2449, 201579, 202388, 203524, 203142)","(203504, 202324, 202330, 202683, 202692)",False
99,0021400100,home,1610612752,NYK,85,away,1610612737,ATL,91,6,-6,1610612752,1610612737,"(202697, 2546, 203499, 203501, 2223)","(201952, 201960, 2594, 200794, 201143)",True
100,0021400101,home,1610612741,CHI,102,away,1610612765,DET,91,11,-11,1610612741,1610612765,"(2200, 2399, 201565, 202710, 201149)","(202328, 2746, 203083, 203484, 201943)",False
101,0021400102,home,1610612746,LAC,85,away,1610612759,SAS,89,-4,4,1610612746,1610612759,"(201599, 200755, 101108, 201933, 2037)","(2225, 1495, 201980, 2588, 202695)",False
102,0021400103,home,1610612761,TOR,104,away,1610612753,ORL,100,-4,4,1610612761,1610612753,"(200768, 101161, 203082, 202685, 201942)","(202696, 101112, 202699, 203901, 203095)",True
103,0021400104,home,1610612763,MEM,107,away,1610612747,LAL,102,-5,5,1610612763,1610612747,"(2216, 201584, 2754, 201144, 201188)","(977, 201941, 202325, 2430, 202391)",True
104,0021400105,home,1610612749,MIL,85,away,1610612760,OKC,78,7,-7,1610612749,1610612760,"(202688, 202336, 201162, 101141, 203953)","(202704, 202498, 203500, 201586, 203087)",False
105,0021400106,home,1610612742,DAL,106,away,1610612758,SAC,98,8,-8,1610612742,1610612758,"(2749, 101145, 1717, 202718, 2199)","(200752, 201196, 202326, 201574, 203463)",False
106,0021400107,home,1610612757,POR,102,away,1610612766,CHA,100,-2,2,1610612757,1610612766,"(201577, 200746, 203459, 202083, 203081)","(2744, 202689, 202362, 101107, 203077)",True
107,0021400108,home,1610612744,GSW,100,away,1610612759,SAS,113,-13,13,1610612744,1610612759,"(201939, 101106, 202691, 203084, 203110)","(2225, 1495, 201980, 2588, 202695)",False
108,0021400109,home,1610612764,WAS,107,away,1610612765,DET,103,-4,4,1610612764,1610612765,"(101162, 2403, 202322, 202066, 1718)","(202328, 2746, 203083, 203484, 201943)",True
109,0021400110,home,1610612737,ATL,100,away,1610612762,UTA,97,3,-3,1610612737,1610612762,"(201952, 2594, 200794, 200757, 201143)","(203504, 202324, 202330, 202683, 202692)",False
110,0021400111,home,1610612738,BOS,94,away,1610612760,OKC,109,-15,15,1610612738,1610612760,"(203096, 201145, 203482, 202340, 200765)","(202704, 202498, 203500, 201586, 203087)",False
111,0021400112,home,1610612748,MIA,75,away,1610612754,IND,81,6,-6,1610612748,1610612754,"(2736, 200761, 202708, 2547, 2548)","(2449, 202388, 201579, 203524, 203142)",True
112,0021400113,home,1610612752,NYK,95,away,1610612753,ORL,97,-2,2,1610612752,1610612753,"(203112, 202697, 2546, 203499, 2223)","(202696, 101112, 202699, 203901, 203095)",False
113,0021400114,home,1610612740,NOP,109,away,1610612747,LAL,102,-7,7,1610612740,1610612747,"(201600, 201569, 201936, 203076, 201950)","(977, 201941, 202325, 2430, 202391)",True
114,0021400115,home,1610612743,DEN,113,away,1610612757,POR,130,-17,17,1610612743,1610612757,"(201163, 201951, 202389, 202702, 201167)","(203081, 200746, 203459, 202083, 201577)",False
115,0021400116,home,1610612756,PHX,112,away,1610612751,BKN,104,-8,8,1610612756,1610612751,"(201609, 202339, 202693, 202694, 203101)","(201572, 101114, 2207, 708, 202711)",True
116,0021400117,home,1610612750,MIN,101,away,1610612745,HOU,113,12,-12,1610612750,1610612745,"(201152, 203952, 2755, 201593, 203897)","(2772, 2730, 202700, 203477, 201935)",True
117,0021400118,home,1610612763,MEM,111,away,1610612758,SAC,110,1,-1,1610612763,1610612758,"(2216, 201144, 2754, 2419, 201188)","(200752, 201954, 202326, 201574, 203463)",False
118,0021400119,home,1610612761,TOR,93,away,1610612741,CHI,100,7,-7,1610612761,1610612741,"(200768, 101161, 203082, 202685, 201942)","(2200, 2399, 201149, 202710, 201565)",True
119,0021400120,home,1610612742,DAL,123,away,1610612755,PHI,70,53,-53,1610612742,1610612755,"(2749, 101145, 1717, 202718, 2199)","(203100, 201601, 203138, 203156, 203909)",False
120,0021400121,home,1610612744,GSW,107,away,1610612751,BKN,99,-8,8,1610612744,1610612751,"(201939, 101106, 202691, 203084, 203110)","(201572, 101114, 2207, 708, 202711)",True
121,0021400122,home,1610612754,IND,87,away,1610612743,DEN,108,21,-21,1610612754,1610612743,"(2449, 202388, 201579, 203524, 203142)","(201163, 201951, 202389, 202702, 201167)",True
122,0021400123,home,1610612753,ORL,101,away,1610612749,MIL,85,-16,16,1610612753,1610612749,"(202696, 101112, 202699, 203901, 203095)","(202688, 202336, 201162, 101141, 203953)",True
123,0021400124,home,1610612737,ATL,114,away,1610612748,MIA,103,11,-11,1610612737,1610612748,"(201952, 2594, 200794, 200757, 201143)","(2736, 200761, 2547, 202708, 203516)",False
124,0021400125,home,1610612738,BOS,121,away,1610612739,CLE,122,-1,1,1610612738,1610612739,"(203096, 201145, 203482, 202340, 200765)","(2760, 2544, 1890, 201567, 202681)",False
125,0021400126,home,1610612752,NYK,100,away,1610612762,UTA,102,-2,2,1610612752,1610612762,"(201160, 202697, 2546, 203499, 2223)","(203504, 202324, 202330, 202683, 202692)",False
126,0021400127,home,1610612745,HOU,88,away,1610612755,PHI,87,1,-1,1610612745,1610612755,"(2772, 2730, 202700, 203477, 201935)","(203100, 201601, 203138, 203156, 203561)",False
127,0021400128,home,1610612740,NOP,139,away,1610612750,MIN,91,-48,48,1610612740,1610612750,"(201600, 201569, 201936, 203076, 201950)","(203952, 203897, 2755, 203476, 201593)",True
128,0021400129,home,1610612760,OKC,89,away,1610612765,DET,96,7,-7,1610612760,1610612765,"(202704, 202498, 203500, 201586, 203087)","(202328, 2746, 203083, 203484, 201943)",True
129,0021400130,home,1610612756,PHX,95,away,1610612766,CHA,103,8,-8,1610612756,1610612766,"(201609, 202339, 202693, 202694, 203101)","(2744, 202689, 202362, 101107, 203798)",True
130,0021400131,home,1610612747,LAL,80,away,1610612759,SAS,93,-13,13,1610612747,1610612759,"(977, 202325, 201941, 2430, 202391)","(2225, 1495, 201980, 2588, 202695)",False
131,0021400132,home,1610612764,WAS,98,away,1610612753,ORL,93,-5,5,1610612764,1610612753,"(101162, 2403, 202066, 202322, 1718)","(202696, 101112, 203506, 202699, 203095)",True
132,0021400133,home,1610612739,CLE,127,away,1610612737,ATL,94,-33,33,1610612739,1610612737,"(2760, 2544, 1890, 201567, 202681)","(201952, 2594, 200794, 200757, 201143)",True
133,0021400134,home,1610612761,TOR,111,away,1610612762,UTA,93,18,-18,1610612761,1610612762,"(200768, 101161, 203082, 202685, 201942)","(203504, 202324, 202330, 202683, 202692)",False
134,0021400135,home,1610612741,CHI,90,away,1610612754,IND,99,-9,9,1610612741,1610612754,"(2200, 2399, 202710, 2550, 201149)","(2449, 202388, 201579, 203524, 203142)",False
135,0021400136,home,1610612763,MEM,95,away,1610612765,DET,88,-7,7,1610612763,1610612765,"(2216, 201144, 2754, 2419, 201188)","(202328, 2746, 203083, 203484, 201943)",True
136,0021400137,home,1610612742,DAL,131,away,1610612750,MIN,117,14,-14,1610612742,1610612750,"(2749, 101145, 1717, 202718, 2199)","(203952, 201593, 2755, 203461, 203897)",False
137,0021400138,home,1610612757,POR,97,away,1610612751,BKN,87,-10,10,1610612757,1610612751,"(203081, 203459, 202083, 203086, 201577)","(201572, 101114, 2207, 708, 202711)",True
138,0021400139,home,1610612758,SAC,94,away,1610612759,SAS,91,3,-3,1610612758,1610612759,"(200752, 201954, 202326, 201574, 203463)","(2225, 1495, 201980, 203382, 202695)",False
139,0021400140,home,1610612744,GSW,112,away,1610612766,CHA,87,-25,25,1610612744,1610612766,"(201939, 101106, 202691, 203084, 203110)","(2744, 202689, 202362, 101107, 203798)",True
140,0021400141,home,1610612746,LAC,120,away,1610612756,PHX,107,13,-13,1610612746,1610612756,"(2440, 200755, 101108, 201933, 201599)","(201609, 202339, 202693, 202694, 203101)",False
141,0021400142,home,1610612752,NYK,109,away,1610612743,DEN,93,-16,16,1610612752,1610612743,"(203112, 2546, 203499, 2747, 2223)","(201163, 201951, 202389, 202702, 201167)",True
142,0021400143,home,1610612748,MIA,84,away,1610612749,MIL,91,-7,7,1610612748,1610612749,"(2736, 200761, 201596, 2547, 202708)","(202688, 202336, 201162, 203507, 203953)",False
143,0021400144,home,1610612760,OKC,65,away,1610612745,HOU,69,4,-4,1610612760,1610612745,"(202704, 202498, 203500, 201586, 203087)","(201976, 2772, 2730, 202700, 201935)",True
144,0021400145,home,1610612747,LAL,115,away,1610612744,GSW,136,21,-21,1610612747,1610612744,"(977, 201941, 202325, 2430, 202391)","(201939, 101106, 202691, 203084, 203110)",True
145,0021400146,home,1610612766,CHA,80,away,1610612742,DAL,107,-27,27,1610612766,1610612742,"(2744, 202689, 202362, 101107, 201945)","(2749, 101145, 1717, 202718, 2199)",False
146,0021400147,home,1610612739,CLE,97,away,1610612743,DEN,106,-9,9,1610612739,1610612743,"(2760, 2544, 1890, 201567, 202681)","(201163, 201951, 202389, 202702, 201167)",False
147,0021400148,home,1610612738,BOS,114,away,1610612756,PHX,118,-4,4,1610612738,1610612756,"(203096, 201145, 203482, 202340, 200765)","(201609, 202339, 202693, 202694, 203101)",False
148,0021400149,home,1610612751,BKN,83,away,1610612748,MIA,95,-12,12,1610612751,1610612748,"(201572, 101114, 2207, 708, 202711)","(200761, 101122, 2547, 202708, 201596)",False
149,0021400150,home,1610612765,DET,93,away,1610612753,ORL,107,-14,14,1610612765,1610612753,"(202328, 2746, 203083, 203484, 201943)","(202696, 101112, 203506, 202699, 203095)",False
150,0021400151,home,1610612763,MEM,119,away,1610612745,HOU,93,-26,26,1610612763,1610612745,"(2216, 201584, 2754, 201144, 201188)","(201976, 2772, 2730, 202700, 201935)",True
151,0021400152,home,1610612759,SAS,100,away,1610612755,PHI,75,-25,25,1610612759,1610612755,"(2225, 1495, 201980, 2588, 202695)","(203100, 201601, 203138, 203156, 203561)",True
152,0021400153,home,1610612757,POR,102,away,1610612740,NOP,93,-9,9,1610612757,1610612740,"(201577, 200746, 203459, 202083, 203081)","(201936, 201569, 203076, 201950, 201582)",True
153,0021400154,home,1610612746,LAC,89,away,1610612741,CHI,105,16,-16,1610612746,1610612741,"(2440, 200755, 101108, 201933, 201599)","(201149, 2399, 202710, 2550, 201959)",True
154,0021400155,home,1610612737,ATL,109,away,1610612747,LAL,114,-5,5,1610612737,1610612747,"(201952, 2594, 200794, 200757, 201143)","(977, 201941, 202325, 2430, 202391)",False
155,0021400156,home,1610612749,MIL,117,away,1610612752,NYK,113,4,-4,1610612749,1610612752,"(202688, 203953, 203114, 203507, 2585)","(202697, 2546, 203499, 2747, 2223)",False
156,0021400157,home,1610612762,UTA,98,away,1610612760,OKC,81,-17,17,1610612762,1610612760,"(203504, 202324, 202330, 202683, 202692)","(202704, 202498, 203500, 201586, 203087)",True
157,0021400158,home,1610612758,SAC,100,away,1610612740,NOP,106,6,-6,1610612758,1610612740,"(200752, 201954, 202326, 201574, 203463)","(201936, 201569, 203076, 201950, 201582)",True
158,0021400159,home,1610612739,CLE,90,away,1610612759,SAS,92,-2,2,1610612739,1610612759,"(2760, 2544, 1890, 201567, 202681)","(2225, 1495, 2564, 201980, 202695)",False
159,0021400160,home,1610612754,IND,88,away,1610612766,CHA,86,-2,2,1610612754,1610612766,"(2449, 202388, 201579, 203524, 203142)","(2744, 202689, 202362, 101107, 201945)",True
160,0021400161,home,1610612753,ORL,90,away,1610612746,LAC,114,24,-24,1610612753,1610612746,"(101112, 202696, 203506, 202699, 2584)","(2440, 200755, 101108, 201933, 201599)",True
161,0021400162,home,1610612755,PHI,90,away,1610612738,BOS,101,11,-11,1610612755,1610612738,"(201601, 203138, 203487, 203156, 203457)","(203096, 201145, 203482, 202340, 200765)",True
162,0021400163,home,1610612764,WAS,102,away,1610612742,DAL,105,3,-3,1610612764,1610612742,"(101162, 2403, 202066, 202322, 1718)","(2749, 101145, 1717, 202718, 2199)",True
163,0021400164,home,1610612751,BKN,118,away,1610612749,MIL,122,-4,4,1610612751,1610612749,"(201572, 101114, 2207, 708, 202711)","(202688, 202336, 203114, 203507, 203953)",False
164,0021400165,home,1610612765,DET,86,away,1610612756,PHX,88,-2,2,1610612765,1610612756,"(202328, 2746, 203083, 203484, 201943)","(201609, 202339, 202693, 202694, 203101)",False
165,0021400166,home,1610612761,TOR,96,away,1610612763,MEM,92,-4,4,1610612761,1610612763,"(200768, 101161, 203082, 202685, 201942)","(2216, 201144, 2419, 202347, 201188)",True
166,0021400167,home,1610612750,MIN,115,away,1610612752,NYK,99,16,-16,1610612750,1610612752,"(203952, 203498, 2755, 203476, 2590)","(203112, 202697, 2546, 203499, 2223)",False
167,0021400168,home,1610612743,DEN,107,away,1610612760,OKC,100,7,-7,1610612743,1610612760,"(201163, 201951, 202389, 202702, 201167)","(202704, 202498, 203500, 201586, 203087)",False
168,0021400169,home,1610612745,HOU,92,away,1610612747,LAL,98,-6,6,1610612745,1610612747,"(201976, 2772, 202700, 204028, 201935)","(977, 202325, 201941, 2430, 202391)",False
169,0021400170,home,1610612748,MIA,93,away,1610612746,LAC,110,17,-17,1610612748,1610612746,"(2736, 200761, 201596, 2547, 202708)","(2440, 200755, 101108, 201933, 201599)",True
170,0021400171,home,1610612758,SAC,103,away,1610612741,CHI,88,-15,15,1610612758,1610612741,"(200752, 201954, 201574, 202326, 203463)","(201149, 2399, 202710, 2550, 201959)",True
171,0021400172,home,1610612766,CHA,100,away,1610612753,ORL,105,-5,5,1610612766,1610612753,"(2744, 202689, 202362, 101107, 201945)","(202696, 101112, 203506, 202699, 203095)",False
172,0021400173,home,1610612755,PHI,96,away,1610612756,PHX,122,-26,26,1610612755,1610612756,"(203100, 201601, 203487, 203156, 203457)","(201609, 202339, 202693, 202694, 203101)",False
173,0021400174,home,1610612737,ATL,99,away,1610612765,DET,89,10,-10,1610612737,1610612765,"(201952, 201960, 2594, 200794, 201143)","(202328, 2746, 203083, 203484, 201943)",False
174,0021400175,home,1610612761,TOR,124,away,1610612749,MIL,82,-42,42,1610612761,1610612749,"(200768, 101161, 203082, 202685, 201942)","(202688, 203953, 203114, 202336, 201573)",True
175,0021400176,home,1610612763,MEM,117,away,1610612738,BOS,100,-17,17,1610612763,1610612738,"(2216, 201584, 2419, 201144, 201188)","(203096, 201145, 203482, 202340, 200765)",True
176,0021400177,home,1610612750,MIN,92,away,1610612759,SAS,121,-29,29,1610612750,1610612759,"(203952, 203498, 201147, 203476, 2590)","(2225, 1495, 2564, 201980, 202695)",False
177,0021400178,home,1610612760,OKC,92,away,1610612751,BKN,94,2,-2,1610612760,1610612751,"(202704, 203500, 202498, 203460, 201586)","(201572, 101114, 2207, 708, 202711)",True
178,0021400179,home,1610612764,WAS,91,away,1610612739,CLE,78,-13,13,1610612764,1610612739,"(101162, 2403, 202322, 202066, 1718)","(2760, 2544, 1890, 201567, 202681)",True
179,0021400180,home,1610612742,DAL,140,away,1610612747,LAL,106,34,-34,1610612742,1610612747,"(2749, 101145, 1717, 202718, 2199)","(977, 202325, 201941, 2430, 202391)",False
180,0021400181,home,1610612743,DEN,117,away,1610612740,NOP,97,20,-20,1610612743,1610612740,"(201163, 201951, 202389, 202702, 201167)","(201936, 201569, 203076, 201950, 201582)",False
181,0021400182,home,1610612744,GSW,101,away,1610612762,UTA,88,13,-13,1610612744,1610612762,"(201939, 101106, 202691, 203084, 203110)","(203504, 202324, 202330, 202683, 202692)",False
182,0021400183,home,1610612757,POR,105,away,1610612741,CHI,87,-18,18,1610612757,1610612741,"(201577, 200746, 202083, 201587, 203081)","(201149, 2399, 202710, 201166, 201959)",True
183,0021400184,home,1610612754,IND,83,away,1610612756,PHX,106,-23,23,1610612754,1610612756,"(2449, 202388, 201579, 203524, 203142)","(201609, 202339, 202693, 202694, 203101)",False
184,0021400185,home,1610612753,ORL,92,away,1610612748,MIA,99,7,-7,1610612753,1610612748,"(202696, 101112, 203506, 2584, 203095)","(2736, 200769, 2547, 201596, 200761)",True
185,0021400186,home,1610612739,CLE,93,away,1610612761,TOR,110,-17,17,1610612739,1610612761,"(2760, 2544, 1890, 201567, 202681)","(200768, 101161, 203082, 202685, 201942)",False
186,0021400187,home,1610612752,NYK,91,away,1610612755,PHI,83,8,-8,1610612752,1610612755,"(203112, 202697, 2546, 101181, 2223)","(203100, 201601, 203487, 203156, 203457)",False
187,0021400188,home,1610612745,HOU,95,away,1610612742,DAL,92,-3,3,1610612745,1610612742,"(201976, 2772, 202700, 204028, 201935)","(2749, 101145, 1717, 202718, 2199)",True
188,0021400189,home,1610612750,MIN,101,away,1610612758,SAC,113,-12,12,1610612750,1610612758,"(203952, 201147, 203476, 203461, 2590)","(200752, 201954, 202326, 201574, 203463)",False
189,0021400190,home,1610612749,MIL,100,away,1610612764,WAS,111,-11,11,1610612749,1610612764,"(202688, 202336, 203114, 203507, 203953)","(101162, 2403, 202322, 202066, 1718)",False
190,0021400191,home,1610612759,SAS,99,away,1610612751,BKN,87,-12,12,1610612759,1610612751,"(2225, 1495, 2564, 201158, 202695)","(101114, 2207, 201572, 203141, 202711)",True
191,0021400192,home,1610612762,UTA,94,away,1610612740,NOP,106,12,-12,1610612762,1610612740,"(203504, 202324, 202330, 202683, 202692)","(201936, 201569, 203076, 201950, 201582)",True
192,0021400193,home,1610612763,MEM,107,away,1610612746,LAC,91,-16,16,1610612763,1610612746,"(2216, 201584, 2754, 201144, 201188)","(2440, 200755, 101108, 201933, 201599)",True
193,0021400194,home,1610612738,BOS,88,away,1610612757,POR,94,-6,6,1610612738,1610612757,"(203096, 201145, 203482, 202340, 200765)","(203081, 200746, 202083, 201587, 201577)",False
194,0021400195,home,1610612748,MIA,94,away,1610612766,CHA,93,-1,1,1610612748,1610612766,"(2736, 200769, 2547, 201596, 200761)","(2744, 202689, 202362, 101107, 201945)",True
195,0021400196,home,1610612760,OKC,86,away,1610612744,GSW,91,5,-5,1610612760,1610612744,"(202704, 203500, 202498, 203460, 201586)","(201939, 101106, 202691, 203084, 203110)",True
196,0021400197,home,1610612747,LAL,94,away,1610612743,DEN,101,7,-7,1610612747,1610612743,"(977, 201941, 202325, 202334, 202391)","(201163, 201951, 202389, 202702, 201167)",True
197,0021400198,home,1610612766,CHA,92,away,1610612746,LAC,113,-21,21,1610612766,1610612746,"(2744, 202689, 202362, 101107, 201945)","(201599, 200755, 101108, 203493, 201933)",False
198,0021400199,home,1610612739,CLE,106,away,1610612753,ORL,74,32,-32,1610612739,1610612753,"(2544, 2760, 1890, 201567, 202681)","(202696, 101112, 203506, 203090, 203095)",False
199,0021400200,home,1610612755,PHI,104,away,1610612757,POR,114,-10,10,1610612755,1610612757,"(203100, 201601, 203487, 203156, 203561)","(203081, 200746, 202083, 201587, 201577)",False
200,0021400201,home,1610612761,TOR,104,away,1610612756,PHX,100,-4,4,1610612761,1610612756,"(200768, 101161, 203082, 202685, 201942)","(201609, 202339, 202693, 202694, 203101)",True
201,0021400202,home,1610612745,HOU,91,away,1610612752,NYK,86,5,-5,1610612745,1610612752,"(2772, 204028, 202700, 203477, 201935)","(203112, 202697, 2546, 101181, 2223)",False
202,0021400203,home,1610612742,DAL,100,away,1610612754,IND,111,-11,11,1610612742,1610612754,"(2749, 101145, 1717, 202718, 2199)","(2449, 202388, 201155, 203524, 101133)",False
203,0021400204,home,1610612762,UTA,95,away,1610612741,CHI,97,2,-2,1610612762,1610612741,"(203504, 202324, 202330, 202683, 202692)","(2200, 2399, 201565, 202710, 201149)",True
204,0021400205,home,1610612764,WAS,102,away,1610612737,ATL,106,4,-4,1610612764,1610612737,"(101162, 202322, 202066, 1718, 2743)","(201952, 201960, 2594, 200794, 201143)",True
205,0021400206,home,1610612748,MIA,97,away,1610612744,GSW,114,17,-17,1610612748,1610612744,"(2736, 200761, 201596, 2547, 202708)","(201939, 101106, 202691, 203084, 203110)",True
206,0021400207,home,1610612749,MIL,98,away,1610612765,DET,86,-12,12,1610612749,1610612765,"(202688, 202336, 203507, 201564, 203953)","(202328, 203083, 201571, 203484, 2746)",True
207,0021400208,home,1610612740,NOP,89,away,1610612758,SAC,99,-10,10,1610612740,1610612758,"(201600, 201936, 203076, 201950, 203121)","(201196, 201956, 202326, 201574, 203463)",False
208,0021400209,home,1610612743,DEN,114,away,1610612741,CHI,109,-5,5,1610612743,1610612741,"(201163, 201951, 202389, 202702, 201167)","(2200, 203946, 201565, 202710, 2399)",True
209,0021400210,home,1610612766,CHA,97,away,1610612757,POR,105,-8,8,1610612766,1610612757,"(2744, 202689, 202362, 101107, 201945)","(203081, 200746, 202083, 201587, 201577)",False
210,0021400211,home,1610612739,CLE,113,away,1610612764,WAS,87,26,-26,1610612739,1610612764,"(2760, 2544, 1890, 201567, 202681)","(101162, 2743, 202322, 203078, 1718)",False
211,0021400212,home,1610612753,ORL,96,away,1610612744,GSW,111,15,-15,1610612753,1610612744,"(202696, 101112, 203506, 202699, 203095)","(201939, 101106, 202691, 203084, 203110)",True
212,0021400213,home,1610612755,PHI,91,away,1610612751,BKN,99,8,-8,1610612755,1610612751,"(203100, 201601, 203487, 203156, 203457)","(201572, 101114, 2207, 708, 202711)",True
213,0021400214,home,1610612742,DAL,109,away,1610612752,NYK,102,7,-7,1610612742,1610612752,"(202718, 101145, 1717, 2734, 2199)","(203112, 202697, 2747, 101181, 2223)",False
214,0021400215,home,1610612737,ATL,115,away,1610612761,TOR,126,-11,11,1610612737,1610612761,"(201952, 201960, 2594, 200794, 201143)","(200768, 101161, 203082, 202685, 201942)",False
215,0021400216,home,1610612765,DET,98,away,1610612746,LAC,104,-6,6,1610612765,1610612746,"(202328, 203083, 201571, 203484, 2746)","(201599, 200755, 101108, 203493, 201933)",False
216,0021400217,home,1610612745,HOU,102,away,1610612758,SAC,89,13,-13,1610612745,1610612758,"(2772, 204028, 202700, 203477, 201935)","(201196, 201956, 202326, 201574, 203463)",False
217,0021400218,home,1610612750,MIN,86,away,1610612749,MIL,103,17,-17,1610612750,1610612749,"(201152, 203952, 201147, 203476, 203897)","(202688, 203953, 203507, 201564, 202336)",True
218,0021400219,home,1610612760,OKC,97,away,1610612762,UTA,82,15,-15,1610612760,1610612762,"(202704, 203460, 202498, 203500, 201586)","(203504, 202324, 202330, 202683, 202692)",False
219,0021400220,home,1610612759,SAS,106,away,1610612754,IND,100,-6,6,1610612759,1610612754,"(2225, 1495, 2564, 201980, 202695)","(2449, 201155, 202388, 101133, 203524)",True
220,0021400221,home,1610612756,PHX,120,away,1610612743,DEN,112,-8,8,1610612756,1610612743,"(201609, 202339, 202693, 202694, 203101)","(201163, 201951, 202389, 202702, 201167)",True
221,0021400222,home,1610612747,LAL,93,away,1610612763,MEM,99,-6,6,1610612747,1610612763,"(977, 202325, 201941, 2430, 202391)","(2216, 201584, 2754, 201144, 201188)",False
222,0021400223,home,1610612738,BOS,102,away,1610612741,CHI,109,-7,7,1610612738,1610612741,"(203096, 201145, 203482, 202340, 200765)","(2200, 2399, 201149, 202710, 201565)",False
223,0021400224,home,1610612766,CHA,101,away,1610612744,GSW,106,-5,5,1610612766,1610612744,"(2744, 202689, 202362, 203469, 201945)","(201939, 101106, 202691, 203084, 203110)",False
224,0021400225,home,1610612737,ATL,100,away,1610612740,NOP,91,9,-9,1610612737,1610612740,"(201952, 201960, 2594, 200794, 201143)","(201600, 201936, 203076, 203085, 201950)",False
225,0021400226,home,1610612765,DET,88,away,1610612749,MIL,104,-16,16,1610612765,1610612749,"(202328, 203083, 201571, 203484, 2746)","(202688, 202336, 203507, 201564, 203953)",False
226,0021400227,home,1610612761,TOR,102,away,1610612742,DAL,106,4,-4,1610612761,1610612742,"(200768, 101161, 203082, 202685, 201942)","(202718, 101145, 1717, 2734, 2199)",True
227,0021400228,home,1610612745,HOU,85,away,1610612746,LAC,102,-17,17,1610612745,1610612746,"(2772, 204028, 202700, 203477, 201935)","(2440, 200755, 101108, 201933, 201599)",False
228,0021400229,home,1610612760,OKC,105,away,1610612752,NYK,78,-27,27,1610612760,1610612752,"(203500, 202498, 203460, 201586, 201566)","(203112, 202697, 2747, 101181, 2223)",True
229,0021400230,home,1610612754,IND,98,away,1610612753,ORL,83,15,-15,1610612754,1610612753,"(2561, 202388, 201155, 203524, 101133)","(202696, 101112, 203506, 202699, 203095)",False
230,0021400231,home,1610612759,SAS,112,away,1610612758,SAC,104,-8,8,1610612759,1610612758,"(2225, 1495, 2564, 201980, 202695)","(200752, 201954, 200797, 201574, 203463)",True
231,0021400232,home,1610612743,DEN,122,away,1610612756,PHX,97,25,-25,1610612743,1610612756,"(201163, 201951, 202389, 202702, 201167)","(201609, 202339, 202693, 202694, 203101)",False
232,0021400233,home,1610612757,POR,99,away,1610612763,MEM,112,13,-13,1610612757,1610612763,"(203081, 200746, 202083, 201587, 201577)","(2216, 201584, 2754, 201144, 201188)",True
233,0021400234,home,1610612747,LAL,119,away,1610612750,MIN,120,-1,1,1610612747,1610612750,"(977, 201941, 202325, 2430, 202391)","(201152, 203952, 201147, 203476, 2590)",False
234,0021400235,home,1610612755,PHI,103,away,1610612742,DAL,110,7,-7,1610612755,1610612742,"(201601, 203138, 203487, 203156, 203457)","(202329, 101145, 202718, 2734, 2199)",True
235,0021400236,home,1610612764,WAS,83,away,1610612740,NOP,80,-3,3,1610612764,1610612740,"(101162, 2743, 202322, 203078, 1718)","(201600, 201936, 203076, 203085, 201950)",True
236,0021400237,home,1610612737,ATL,105,away,1610612766,CHA,75,30,-30,1610612737,1610612766,"(201952, 201960, 2594, 200794, 201143)","(2744, 202689, 202362, 203469, 201945)",False
237,0021400238,home,1610612739,CLE,109,away,1610612754,IND,97,12,-12,1610612739,1610612754,"(2544, 202681, 1890, 202684, 201567)","(2561, 202388, 201155, 203524, 101133)",False
238,0021400239,home,1610612762,UTA,96,away,1610612746,LAC,112,16,-16,1610612762,1610612746,"(203504, 202324, 202330, 202683, 202692)","(2440, 200755, 101108, 201933, 201599)",True
239,0021400240,home,1610612749,MIL,103,away,1610612745,HOU,117,14,-14,1610612749,1610612745,"(202688, 202336, 203507, 201564, 203953)","(2772, 1891, 202700, 204028, 201935)",True
240,0021400241,home,1610612738,BOS,89,away,1610612759,SAS,111,-22,22,1610612738,1610612759,"(203096, 201145, 202340, 203092, 200765)","(2225, 1495, 2564, 201980, 202695)",False
241,0021400242,home,1610612751,BKN,84,away,1610612741,CHI,102,-18,18,1610612751,1610612741,"(201572, 101114, 2207, 708, 202711)","(2200, 201565, 201149, 202710, 2399)",False
242,0021400243,home,1610612765,DET,93,away,1610612744,GSW,104,-11,11,1610612765,1610612744,"(202713, 2746, 203083, 203484, 201943)","(201939, 101106, 202691, 203084, 203110)",False
243,0021400244,home,1610612758,SAC,85,away,1610612763,MEM,97,12,-12,1610612758,1610612763,"(200752, 201954, 200797, 201574, 203463)","(2216, 201584, 2754, 201144, 201188)",True
244,0021400245,home,1610612752,NYK,79,away,1610612748,MIA,86,7,-7,1610612752,1610612748,"(203112, 202697, 2546, 101181, 2223)","(2736, 202708, 2547, 2548, 200761)",True
245,0021400246,home,1610612756,PHX,90,away,1610612753,ORL,93,3,-3,1610612756,1610612753,"(201609, 202339, 202693, 202694, 203101)","(202696, 101112, 203506, 202699, 203095)",True
246,0021400247,home,1610612757,POR,107,away,1610612750,MIN,93,-14,14,1610612757,1610612750,"(203081, 200746, 202083, 201587, 201577)","(201152, 203952, 201147, 203476, 2590)",True
247,0021400248,home,1610612747,LAL,129,away,1610612761,TOR,122,7,-7,1610612747,1610612761,"(977, 201941, 202325, 2430, 202391)","(200768, 101161, 203082, 202349, 202685)",False
248,0021400249,home,1610612755,PHI,103,away,1610612759,SAS,109,-6,6,1610612755,1610612759,"(201601, 203138, 203487, 203156, 203561)","(201980, 2564, 202709, 203382, 202695)",False
249,0021400250,home,1610612764,WAS,107,away,1610612748,MIA,86,-21,21,1610612764,1610612748,"(101162, 2743, 202322, 203078, 1718)","(2736, 202708, 2547, 2548, 200761)",True
250,0021400251,home,1610612762,UTA,101,away,1610612743,DEN,103,2,-2,1610612762,1610612743,"(202344, 203504, 202330, 202683, 202692)","(201163, 201951, 202389, 202702, 201167)",True
251,0021400252,home,1610612746,LAC,127,away,1610612750,MIN,101,26,-26,1610612746,1610612750,"(2440, 200755, 101108, 201933, 201599)","(201152, 203952, 201147, 203476, 2590)",False
252,0021400253,home,1610612739,CLE,111,away,1610612749,MIL,108,3,-3,1610612739,1610612749,"(2760, 2544, 1890, 201567, 202681)","(202688, 202336, 203507, 201564, 203953)",False
253,0021400254,home,1610612737,ATL,109,away,1610612738,BOS,105,4,-4,1610612737,1610612738,"(201952, 201960, 2594, 200794, 201143)","(203096, 203092, 202340, 200765, 201145)",False
254,0021400255,home,1610612765,DET,96,away,1610612747,LAL,106,-10,10,1610612765,1610612747,"(202713, 2746, 203083, 203484, 201943)","(977, 201941, 202325, 2430, 202391)",False
255,0021400256,home,1610612752,NYK,93,away,1610612751,BKN,98,5,-5,1610612752,1610612751,"(202697, 2546, 101181, 2405, 2223)","(201572, 101114, 2207, 708, 202711)",True
256,0021400257,home,1610612741,CHI,129,away,1610612742,DAL,132,-3,3,1610612741,1610612742,"(2200, 2399, 201565, 202710, 201149)","(101145, 2199, 2749, 202718, 1717)",False
257,0021400258,home,1610612740,NOP,112,away,1610612760,OKC,104,8,-8,1610612740,1610612760,"(201600, 202337, 201936, 201950, 203076)","(203500, 201586, 203460, 201142, 201566)",False
258,0021400259,home,1610612743,DEN,103,away,1610612757,POR,105,-2,2,1610612743,1610612757,"(201163, 201951, 202389, 202702, 201167)","(203081, 200746, 202083, 201587, 201577)",False
259,0021400260,home,1610612756,PHX,116,away,1610612754,IND,99,-17,17,1610612756,1610612754,"(201609, 202339, 202693, 200782, 203101)","(2561, 202388, 201579, 203524, 201155)",True
260,0021400261,home,1610612758,SAC,109,away,1610612761,TOR,117,-8,8,1610612758,1610612761,"(200752, 201954, 200797, 201574, 203463)","(200768, 101161, 203082, 202349, 202685)",False
261,0021400262,home,1610612744,GSW,98,away,1610612753,ORL,97,1,-1,1610612744,1610612753,"(201939, 101106, 202691, 203084, 203110)","(101112, 203506, 202699, 203124, 203095)",False
262,0021400263,home,1610612766,CHA,95,away,1610612741,CHI,102,-7,7,1610612766,1610612741,"(2744, 202689, 202362, 203469, 201945)","(2200, 2399, 201149, 202710, 201565)",False
263,0021400264,home,1610612764,WAS,111,away,1610612747,LAL,95,-16,16,1610612764,1610612747,"(101162, 1718, 202322, 203078, 2743)","(977, 201941, 202325, 2430, 202391)",True
264,0021400265,home,1610612738,BOS,109,away,1610612765,DET,102,7,-7,1610612738,1610612765,"(203096, 203092, 202340, 200765, 201145)","(202713, 2746, 203083, 203484, 201943)",False
265,0021400266,home,1610612751,BKN,95,away,1610612759,SAS,93,2,-2,1610612751,1610612759,"(101114, 2207, 201572, 203141, 202711)","(2225, 1495, 2564, 201980, 202695)",False
266,0021400267,home,1610612748,MIA,102,away,1610612737,ATL,112,10,-10,1610612748,1610612737,"(2736, 201177, 201596, 2547, 2548)","(201952, 201960, 2594, 200794, 201143)",True
267,0021400268,home,1610612745,HOU,105,away,1610612763,MEM,96,9,-9,1610612745,1610612763,"(2772, 1891, 202700, 204028, 201935)","(2216, 201584, 2754, 201144, 201188)",False
268,0021400269,home,1610612749,MIL,105,away,1610612742,DAL,107,2,-2,1610612749,1610612742,"(202688, 202336, 203507, 201564, 203953)","(202329, 101145, 2749, 202718, 2199)",True
269,0021400270,home,1610612750,MIN,77,away,1610612755,PHI,85,-8,8,1610612750,1610612755,"(201152, 203952, 201147, 203476, 2590)","(201601, 203138, 203487, 203156, 203457)",False
270,0021400271,home,1610612762,UTA,104,away,1610612761,TOR,123,19,-19,1610612762,1610612761,"(203504, 202330, 202683, 202324, 203918)","(200768, 101161, 203082, 202349, 202685)",True
271,0021400272,home,1610612746,LAC,114,away,1610612753,ORL,86,28,-28,1610612746,1610612753,"(2440, 200755, 101108, 201933, 201599)","(101112, 203506, 202699, 203124, 203095)",False
272,0021400273,home,1610612752,NYK,87,away,1610612739,CLE,90,3,-3,1610612752,1610612739,"(203112, 202697, 2546, 2405, 101181)","(2544, 2760, 1890, 201567, 202681)",True
273,0021400274,home,1610612757,POR,88,away,1610612754,IND,82,-6,6,1610612757,1610612754,"(201577, 200746, 202083, 201587, 203081)","(2561, 201579, 203524, 203142, 201155)",True
274,0021400275,home,1610612744,GSW,112,away,1610612740,NOP,85,27,-27,1610612744,1610612740,"(201939, 101106, 202691, 203084, 203110)","(201600, 202337, 201936, 203076, 201950)",False
275,0021400276,home,1610612766,CHA,103,away,1610612752,NYK,102,1,-1,1610612766,1610612752,"(2744, 202689, 202362, 203469, 201945)","(202697, 2546, 101181, 2405, 2223)",False
276,0021400277,home,1610612755,PHI,91,away,1610612760,OKC,103,12,-12,1610612755,1610612760,"(201601, 203138, 203487, 203156, 203457)","(203500, 201586, 203460, 201566, 201142)",True
277,0021400278,home,1610612764,WAS,119,away,1610612743,DEN,89,-30,30,1610612764,1610612743,"(101162, 2743, 202322, 203078, 1718)","(201163, 201951, 202389, 202702, 201167)",True
278,0021400279,home,1610612738,BOS,113,away,1610612747,LAL,96,17,-17,1610612738,1610612747,"(203096, 203092, 202340, 200765, 201145)","(977, 202325, 201941, 2430, 202391)",False
279,0021400280,home,1610612751,BKN,75,away,1610612737,ATL,98,23,-23,1610612751,1610612737,"(708, 101114, 2207, 201572, 202711)","(201952, 201960, 2594, 200794, 201143)",True
280,0021400281,home,1610612761,TOR,91,away,1610612739,CLE,105,14,-14,1610612761,1610612739,"(200768, 101161, 203082, 202349, 202685)","(2760, 2544, 1890, 201567, 202681)",True
281,0021400282,home,1610612763,MEM,101,away,1610612759,SAS,107,-6,6,1610612763,1610612759,"(2216, 201584, 2754, 201144, 201188)","(2225, 1495, 201980, 2588, 202695)",False
282,0021400283,home,1610612750,MIN,112,away,1610612745,HOU,114,2,-2,1610612750,1610612745,"(201152, 203952, 201147, 203476, 203897)","(2772, 1891, 202700, 204028, 201935)",True
283,0021400284,home,1610612742,DAL,106,away,1610612756,PHX,118,-12,12,1610612742,1610612756,"(2749, 101145, 1717, 202718, 2199)","(201609, 202339, 202693, 200782, 203101)",False
284,0021400285,home,1610612749,MIL,109,away,1610612748,MIA,85,-24,24,1610612749,1610612748,"(202688, 2585, 203507, 201564, 203953)","(201177, 101122, 2547, 2548, 201596)",True
285,0021400286,home,1610612762,UTA,93,away,1610612753,ORL,98,5,-5,1610612762,1610612753,"(203504, 202330, 202683, 202324, 203918)","(101112, 203506, 202699, 203124, 203095)",True
286,0021400287,home,1610612758,SAC,102,away,1610612754,IND,101,-1,1,1610612758,1610612754,"(200752, 201954, 200797, 201574, 203463)","(201579, 2561, 201155, 203524, 203142)",True
287,0021400288,home,1610612765,DET,101,away,1610612755,PHI,108,-7,7,1610612765,1610612755,"(202713, 2746, 203083, 203484, 201943)","(201601, 203138, 203487, 203156, 203457)",False
288,0021400289,home,1610612741,CHI,102,away,1610612744,GSW,112,-10,10,1610612741,1610612744,"(2200, 2399, 201565, 202710, 201149)","(201939, 101106, 202691, 203084, 203110)",False
289,0021400290,home,1610612745,HOU,100,away,1610612756,PHX,95,5,-5,1610612745,1610612756,"(2772, 1891, 202700, 204028, 201935)","(201609, 202339, 202693, 200782, 203101)",False
290,0021400291,home,1610612759,SAS,123,away,1610612750,MIN,101,-22,22,1610612759,1610612750,"(2588, 1495, 201980, 202709, 202695)","(201152, 203952, 201147, 203476, 203897)",True
291,0021400292,home,1610612758,SAC,96,away,1610612753,ORL,105,9,-9,1610612758,1610612753,"(200752, 201954, 200797, 201574, 203463)","(101112, 203506, 202699, 203124, 203095)",True
292,0021400293,home,1610612746,LAC,120,away,1610612740,NOP,100,20,-20,1610612746,1610612740,"(2440, 200755, 101108, 201933, 201599)","(201600, 202337, 201936, 203076, 201950)",False
293,0021400294,home,1610612738,BOS,101,away,1610612764,WAS,93,8,-8,1610612738,1610612764,"(203096, 203092, 202340, 200765, 201145)","(101162, 2743, 202322, 203078, 1718)",False
294,0021400295,home,1610612737,ATL,96,away,1610612743,DEN,84,12,-12,1610612737,1610612743,"(201952, 201960, 2594, 200794, 201143)","(202389, 201163, 201581, 201951, 201167)",False
295,0021400296,home,1610612763,MEM,103,away,1610612748,MIA,87,16,-16,1610612763,1610612748,"(2216, 201584, 2754, 201144, 201188)","(2736, 201177, 202708, 2547, 2548)",False
296,0021400297,home,1610612765,DET,94,away,1610612760,OKC,96,-2,2,1610612765,1610612760,"(202713, 2746, 203083, 203484, 201943)","(203500, 201586, 203460, 201566, 201142)",False
297,0021400298,home,1610612742,DAL,125,away,1610612749,MIL,102,23,-23,1610612742,1610612749,"(2749, 101145, 1717, 202718, 2199)","(202688, 202336, 203507, 201564, 203953)",False
298,0021400299,home,1610612752,NYK,99,away,1610612757,POR,103,-4,4,1610612752,1610612757,"(203112, 202697, 2546, 2405, 101181)","(201577, 200746, 202083, 201587, 203081)",False
299,0021400300,home,1610612747,LAL,87,away,1610612740,NOP,104,-17,17,1610612747,1610612740,"(977, 101179, 201941, 202334, 202325)","(201600, 202337, 201936, 203076, 201950)",False
300,0021400301,home,1610612754,IND,92,away,1610612737,ATL,108,16,-16,1610612754,1610612737,"(201579, 2561, 201155, 203524, 203142)","(201952, 201960, 2594, 200794, 201143)",True
301,0021400302,home,1610612764,WAS,133,away,1610612738,BOS,132,-1,1,1610612764,1610612738,"(101162, 2743, 202322, 203078, 1718)","(203096, 203092, 202340, 200765, 201145)",True
302,0021400303,home,1610612751,BKN,88,away,1610612739,CLE,110,-22,22,1610612751,1610612739,"(101114, 101187, 708, 203141, 202711)","(2760, 2544, 1890, 201567, 202681)",False
303,0021400304,home,1610612761,TOR,112,away,1610612743,DEN,107,-5,5,1610612761,1610612743,"(200768, 101161, 203082, 202349, 202685)","(201163, 201951, 201581, 201167, 202389)",True
304,0021400305,home,1610612750,MIN,86,away,1610612744,GSW,102,16,-16,1610612750,1610612744,"(201152, 203952, 201147, 203476, 203897)","(201939, 101106, 202691, 203084, 203110)",True
305,0021400306,home,1610612758,SAC,101,away,1610612762,UTA,92,9,-9,1610612758,1610612762,"(200752, 201954, 2501, 201574, 203463)","(203504, 202324, 202330, 202683, 202692)",False
306,0021400307,home,1610612746,LAC,121,away,1610612756,PHX,120,1,-1,1610612746,1610612756,"(2440, 200755, 101108, 201933, 201599)","(201609, 202339, 202693, 200782, 203101)",False
307,0021400308,home,1610612739,CLE,105,away,1610612761,TOR,101,4,-4,1610612739,1610612761,"(2760, 2544, 1890, 201567, 202681)","(200768, 101161, 203082, 202685, 202361)",False
308,0021400309,home,1610612765,DET,86,away,1610612757,POR,98,-12,12,1610612765,1610612757,"(202713, 2746, 203083, 203484, 201943)","(203081, 200746, 202083, 201587, 201577)",False
309,0021400310,home,1610612763,MEM,114,away,1610612742,DAL,105,-9,9,1610612763,1610612742,"(2216, 201584, 2754, 201144, 201188)","(2749, 101145, 1717, 202718, 2199)",True
310,0021400311,home,1610612740,NOP,104,away,1610612752,NYK,93,11,-11,1610612740,1610612752,"(201600, 202337, 201936, 203076, 201950)","(203112, 202697, 2546, 2405, 101181)",False
311,0021400312,home,1610612760,OKC,114,away,1610612749,MIL,101,-13,13,1610612760,1610612749,"(203500, 201586, 203460, 201566, 201142)","(202688, 202336, 203507, 201564, 203953)",True
312,0021400313,home,1610612756,PHX,97,away,1610612748,MIA,103,6,-6,1610612756,1610612748,"(201609, 202339, 202693, 200782, 203101)","(2736, 201177, 202708, 2547, 2548)",True
313,0021400314,home,1610612762,UTA,100,away,1610612759,SAS,96,-4,4,1610612762,1610612759,"(203504, 202324, 202330, 202683, 202692)","(201980, 1495, 2588, 202709, 202695)",True
314,0021400315,home,1610612747,LAL,98,away,1610612758,SAC,95,3,-3,1610612747,1610612758,"(977, 101179, 201941, 202334, 202325)","(200752, 201954, 2501, 201574, 203463)",False
315,0021400316,home,1610612766,CHA,96,away,1610612738,BOS,87,-9,9,1610612766,1610612738,"(2744, 202689, 202362, 203469, 201945)","(203096, 203092, 202340, 200765, 201145)",True
316,0021400317,home,1610612754,IND,96,away,1610612746,LAC,103,-7,7,1610612754,1610612746,"(201579, 2561, 201155, 203524, 203142)","(2440, 200755, 101108, 201933, 201599)",False
317,0021400318,home,1610612753,ORL,89,away,1610612764,WAS,91,-2,2,1610612753,1610612764,"(101112, 203506, 202699, 203124, 203095)","(101162, 1718, 202322, 203078, 2743)",False
318,0021400319,home,1610612737,ATL,95,away,1610612755,PHI,79,16,-16,1610612737,1610612755,"(201952, 201960, 2594, 200794, 201143)","(201601, 203138, 203487, 203156, 203457)",False
319,0021400320,home,1610612741,CHI,105,away,1610612751,BKN,80,-25,25,1610612741,1610612751,"(2200, 2399, 201565, 202710, 201959)","(203508, 101114, 101187, 708, 203486)",True
320,0021400321,home,1610612750,MIN,90,away,1610612757,POR,82,8,-8,1610612750,1610612757,"(201152, 203952, 201147, 203476, 203897)","(203081, 200746, 202083, 201587, 201577)",False
321,0021400322,home,1610612759,SAS,109,away,1610612752,NYK,95,-14,14,1610612759,1610612752,"(203937, 201980, 202709, 203382, 2588)","(203112, 202697, 101181, 2405, 203501)",True
322,0021400323,home,1610612742,DAL,112,away,1610612740,NOP,107,5,-5,1610612742,1610612740,"(101145, 200826, 1717, 202718, 2199)","(201600, 202337, 201936, 203076, 201950)",False
323,0021400324,home,1610612744,GSW,105,away,1610612745,HOU,93,12,-12,1610612744,1610612745,"(201939, 203105, 202691, 203084, 203110)","(201976, 2772, 202700, 204028, 201935)",False
324,0021400325,home,1610612743,DEN,102,away,1610612748,MIA,82,20,-20,1610612743,1610612748,"(202389, 201163, 201581, 201951, 201167)","(203120, 2736, 2547, 202708, 2548)",False
325,0021400326,home,1610612760,OKC,103,away,1610612739,CLE,94,-9,9,1610612760,1610612739,"(203500, 201586, 203460, 201566, 201142)","(2760, 203521, 1890, 201567, 202681)",True
326,0021400327,home,1610612758,SAC,109,away,1610612745,HOU,113,4,-4,1610612758,1610612745,"(200752, 201954, 2501, 201574, 203463)","(201976, 2772, 202700, 204028, 201935)",True
327,0021400328,home,1610612741,CHI,115,away,1610612757,POR,106,9,-9,1610612741,1610612757,"(2200, 2399, 201565, 202710, 201959)","(203081, 200746, 202083, 201587, 201577)",False
328,0021400329,home,1610612764,WAS,104,away,1610612746,LAC,96,-8,8,1610612764,1610612746,"(101162, 2743, 202322, 203078, 1718)","(2440, 200755, 101108, 201933, 201599)",True
329,0021400330,home,1610612737,ATL,87,away,1610612753,ORL,81,6,-6,1610612737,1610612753,"(201952, 201960, 2594, 200794, 201143)","(101112, 203506, 202699, 203124, 203095)",False
330,0021400331,home,1610612738,BOS,95,away,1610612752,NYK,101,-6,6,1610612738,1610612752,"(203096, 201145, 202323, 203092, 200765)","(203112, 202697, 2546, 2405, 101181)",False
331,0021400332,home,1610612751,BKN,88,away,1610612755,PHI,70,18,-18,1610612751,1610612755,"(203508, 101114, 708, 203486, 2207)","(203496, 201601, 203138, 203487, 203457)",False
332,0021400333,home,1610612761,TOR,106,away,1610612754,IND,94,-12,12,1610612761,1610612754,"(200768, 101161, 203082, 202685, 202361)","(101139, 2561, 201155, 201579, 201228)",True
333,0021400334,home,1610612763,MEM,113,away,1610612766,CHA,107,-6,6,1610612763,1610612766,"(2216, 201584, 2754, 201144, 201188)","(2744, 202689, 202362, 203469, 201945)",True
334,0021400335,home,1610612750,MIN,92,away,1610612760,OKC,111,-19,19,1610612750,1610612760,"(201152, 203952, 201147, 203476, 203897)","(203500, 201586, 203460, 201566, 201142)",False
335,0021400337,home,1610612756,PHX,103,away,1610612765,DET,105,2,-2,1610612756,1610612765,"(201609, 202339, 202693, 200782, 203101)","(202328, 2746, 203083, 203484, 201943)",True
336,0021400338,home,1610612762,UTA,95,away,1610612748,MIA,100,5,-5,1610612762,1610612748,"(203504, 202324, 202330, 202683, 202692)","(2736, 203120, 202708, 2547, 2548)",True
337,0021400339,home,1610612759,SAS,110,away,1610612747,LAL,112,2,-2,1610612759,1610612747,"(203937, 1495, 201980, 2588, 2225)","(977, 101179, 201941, 202334, 202325)",True
338,0021400340,home,1610612742,DAL,98,away,1610612744,GSW,105,-7,7,1610612742,1610612744,"(2749, 101145, 2210, 1717, 2199)","(201939, 203105, 202691, 203084, 203110)",False
339,0021400341,home,1610612766,CHA,87,away,1610612751,BKN,114,27,-27,1610612766,1610612751,"(2744, 202689, 202362, 203469, 201945)","(203928, 101114, 203508, 203486, 2207)",True
340,0021400342,home,1610612754,IND,85,away,1610612757,POR,95,-10,10,1610612754,1610612757,"(2561, 201579, 203524, 201228, 201155)","(203081, 200746, 202083, 201587, 201577)",False
341,0021400343,home,1610612753,ORL,100,away,1610612737,ATL,99,-1,1,1610612753,1610612737,"(202696, 101112, 203506, 202699, 203095)","(201952, 201960, 2594, 200794, 201143)",True
342,0021400344,home,1610612749,MIL,111,away,1610612746,LAC,106,-5,5,1610612749,1610612746,"(202688, 202336, 203507, 201564, 203953)","(2440, 200755, 101108, 201933, 201599)",True
343,0021400345,home,1610612755,PHI,115,away,1610612763,MEM,120,5,-5,1610612755,1610612763,"(203496, 201601, 203138, 203487, 203457)","(201584, 2216, 2754, 201144, 201188)",True
344,0021400347,home,1610612758,SAC,90,away,1610612765,DET,95,5,-5,1610612758,1610612765,"(200752, 201954, 200797, 201574, 203463)","(202713, 2746, 203083, 203484, 201943)",True
345,0021400348,home,1610612740,NOP,122,away,1610612744,GSW,128,6,-6,1610612740,1610612744,"(201600, 202337, 201936, 201950, 201583)","(201939, 203105, 202691, 203084, 203110)",True
346,0021400349,home,1610612748,MIA,75,away,1610612741,CHI,93,18,-18,1610612748,1610612741,"(203120, 2736, 202708, 2548, 2617)","(2200, 2399, 201565, 202710, 201959)",True
347,0021400350,home,1610612764,WAS,93,away,1610612762,UTA,84,-9,9,1610612764,1610612762,"(101162, 2743, 202322, 203078, 1718)","(203504, 203497, 202330, 202683, 202692)",True
348,0021400351,home,1610612750,MIN,94,away,1610612747,LAL,100,6,-6,1610612750,1610612747,"(201152, 203952, 201147, 203476, 203897)","(977, 101179, 201941, 202334, 202325)",True
349,0021400352,home,1610612760,OKC,112,away,1610612756,PHX,88,24,-24,1610612760,1610612756,"(203500, 201586, 203460, 201566, 201142)","(202339, 101123, 202693, 200782, 203101)",False
350,0021400353,home,1610612752,NYK,90,away,1610612761,TOR,95,-5,5,1610612752,1610612761,"(203112, 2546, 101181, 2405, 203501)","(200768, 101161, 203082, 202685, 202361)",False
351,0021400354,home,1610612743,DEN,91,away,1610612759,SAS,99,-8,8,1610612743,1610612759,"(202389, 201163, 201581, 201951, 201167)","(201168, 1495, 201980, 202709, 202695)",False
352,0021400355,home,1610612739,CLE,97,away,1610612766,CHA,88,-9,9,1610612739,1610612766,"(2760, 2544, 1890, 201567, 202681)","(2744, 202689, 202362, 203077, 203469)",True
353,0021400356,home,1610612754,IND,110,away,1610612747,LAL,91,19,-19,1610612754,1610612747,"(201579, 2561, 201155, 203524, 201228)","(977, 101179, 201941, 202334, 202325)",False
354,0021400357,home,1610612755,PHI,87,away,1610612738,BOS,105,18,-18,1610612755,1610612738,"(203496, 201601, 203138, 203487, 203457)","(203096, 203092, 202340, 200765, 201145)",True
355,0021400358,home,1610612737,ATL,93,away,1610612741,CHI,86,7,-7,1610612737,1610612741,"(201952, 201960, 2594, 200794, 201143)","(2200, 2399, 201565, 202710, 201959)",False
356,0021400359,home,1610612761,TOR,95,away,1610612753,ORL,82,-13,13,1610612761,1610612753,"(200768, 101161, 203082, 202685, 202361)","(202696, 101112, 203506, 202699, 203095)",True
357,0021400360,home,1610612756,PHX,94,away,1610612749,MIL,96,2,-2,1610612756,1610612749,"(202339, 203458, 101123, 202693, 200782)","(202688, 202336, 203507, 201564, 203953)",True
358,0021400361,home,1610612757,POR,108,away,1610612759,SAS,95,13,-13,1610612757,1610612759,"(201577, 200746, 202083, 201587, 203081)","(201980, 2564, 202709, 203382, 202695)",False
359,0021400362,home,1610612746,LAC,113,away,1610612765,DET,91,-22,22,1610612746,1610612765,"(2440, 200755, 101108, 201933, 201599)","(202713, 2746, 203083, 203484, 201943)",True
360,0021400363,home,1610612764,WAS,109,away,1610612750,MIN,95,-14,14,1610612764,1610612750,"(203490, 202322, 101162, 203078, 2743)","(201152, 203952, 201147, 203476, 203897)",True
361,0021400364,home,1610612751,BKN,91,away,1610612748,MIA,95,-4,4,1610612751,1610612748,"(203508, 101114, 708, 203486, 2207)","(203120, 2736, 202708, 2548, 2617)",False
362,0021400365,home,1610612763,MEM,105,away,1610612744,GSW,98,-7,7,1610612763,1610612744,"(2216, 201584, 2754, 201144, 201188)","(201939, 203105, 202691, 203084, 203110)",True
363,0021400366,home,1610612740,NOP,119,away,1610612762,UTA,111,8,-8,1610612740,1610612762,"(201600, 202337, 201936, 201950, 203076)","(203504, 203497, 202330, 202683, 202692)",False
364,0021400367,home,1610612752,NYK,87,away,1610612742,DAL,107,20,-20,1610612752,1610612742,"(203112, 2546, 101181, 2405, 203501)","(2749, 101145, 1717, 202718, 2199)",True
365,0021400368,home,1610612758,SAC,92,away,1610612760,OKC,104,12,-12,1610612758,1610612760,"(200752, 201954, 2501, 201574, 203463)","(203500, 201586, 203460, 201566, 201142)",True
366,0021400369,home,1610612766,CHA,106,away,1610612756,PHX,111,-5,5,1610612766,1610612756,"(2744, 202689, 202362, 203469, 203077)","(201609, 203458, 202339, 202693, 200782)",False
367,0021400370,home,1610612739,CLE,98,away,1610612737,ATL,127,29,-29,1610612739,1610612737,"(2760, 2544, 1890, 201567, 202681)","(201960, 2594, 201143, 200794, 203471)",True
368,0021400371,home,1610612738,BOS,109,away,1610612753,ORL,92,17,-17,1610612738,1610612753,"(203096, 203092, 202340, 200765, 201145)","(202696, 101112, 203506, 202699, 203095)",False
369,0021400372,home,1610612765,DET,106,away,1610612742,DAL,117,11,-11,1610612765,1610612742,"(202713, 2746, 203083, 203484, 201943)","(2749, 101145, 1717, 202718, 2199)",True
370,0021400373,home,1610612748,MIA,87,away,1610612762,UTA,105,-18,18,1610612748,1610612762,"(2736, 203120, 202708, 2548, 2365)","(203504, 202324, 202330, 202683, 202692)",False
371,0021400374,home,1610612761,TOR,105,away,1610612751,BKN,89,-16,16,1610612761,1610612751,"(200768, 101161, 203082, 202685, 202361)","(101114, 101187, 203141, 203486, 2207)",True
372,0021400375,home,1610612759,SAS,116,away,1610612763,MEM,117,1,-1,1610612759,1610612763,"(203937, 201980, 202709, 2588, 1495)","(2216, 201584, 202347, 201188, 201144)",True
373,0021400376,home,1610612757,POR,104,away,1610612749,MIL,97,-7,7,1610612757,1610612749,"(203080, 203081, 200746, 202083, 201587)","(202688, 202336, 201162, 203507, 201564)",True
374,0021400377,home,1610612746,LAC,102,away,1610612754,IND,100,-2,2,1610612746,1610612754,"(2440, 200755, 101108, 201933, 201599)","(201579, 2561, 201155, 203524, 201228)",True
375,0021400379,home,1610612741,CHI,103,away,1610612752,NYK,97,6,-6,1610612741,1610612752,"(2200, 2399, 202710, 2550, 201149)","(202332, 203501, 101181, 204037, 2405)",False
376,0021400380,home,1610612745,HOU,90,away,1610612740,NOP,99,-9,9,1610612745,1610612740,"(201976, 2772, 2730, 202700, 201935)","(201600, 202337, 203076, 203085, 201950)",False
377,0021400381,home,1610612758,SAC,107,away,1610612749,MIL,108,1,-1,1610612758,1610612749,"(200752, 201954, 202326, 201574, 203463)","(202688, 2585, 203507, 203948, 201564)",True
378,0021400382,home,1610612744,GSW,114,away,1610612760,OKC,109,5,-5,1610612744,1610612760,"(201939, 203105, 202691, 203084, 203110)","(203500, 201586, 203460, 201566, 201142)",False
379,0021400383,home,1610612753,ORL,94,away,1610612762,UTA,101,-7,7,1610612753,1610612762,"(202696, 101112, 203506, 202699, 203095)","(203504, 202324, 202330, 202683, 202692)",False
380,0021400384,home,1610612755,PHI,91,away,1610612766,CHA,109,18,-18,1610612755,1610612766,"(203496, 201601, 203138, 203487, 203457)","(2744, 202689, 201945, 203077, 203469)",True
381,0021400385,home,1610612738,BOS,114,away,1610612750,MIN,98,16,-16,1610612738,1610612750,"(203096, 203092, 202323, 202340, 201145)","(201152, 203952, 203498, 203476, 203897)",False
382,0021400386,home,1610612739,CLE,95,away,1610612751,BKN,91,-4,4,1610612739,1610612751,"(2760, 2544, 2034, 201567, 202681)","(203508, 101114, 708, 203486, 2207)",True
383,0021400387,home,1610612765,DET,100,away,1610612761,TOR,110,-10,10,1610612765,1610612761,"(202713, 2746, 203083, 203484, 201943)","(200768, 101161, 203082, 202685, 202361)",False
384,0021400388,home,1610612748,MIA,103,away,1610612764,WAS,105,-2,2,1610612748,1610612764,"(2736, 200761, 201596, 2548, 2365)","(101162, 2743, 202322, 203078, 1718)",False
385,0021400389,home,1610612763,MEM,97,away,1610612741,CHI,103,6,-6,1610612763,1610612741,"(2216, 201584, 2419, 201144, 201188)","(2200, 2399, 2550, 202710, 201149)",True
386,0021400390,home,1610612759,SAS,119,away,1610612757,POR,129,10,-10,1610612759,1610612757,"(203937, 201980, 2564, 202709, 1495)","(203081, 200746, 203459, 202083, 200777)",True
387,0021400391,home,1610612743,DEN,109,away,1610612746,LAC,106,3,-3,1610612743,1610612746,"(201163, 201951, 202389, 202702, 201167)","(2440, 200755, 101108, 201933, 201599)",False
388,0021400392,home,1610612747,LAL,103,away,1610612760,OKC,104,-1,1,1610612747,1610612760,"(977, 101179, 202325, 202334, 201941)","(203500, 201586, 203460, 201566, 203103)",False
389,0021400393,home,1610612752,NYK,90,away,1610612756,PHX,99,-9,9,1610612752,1610612756,"(203112, 2546, 202332, 203501, 101181)","(201609, 203458, 202339, 202693, 200782)",False
390,0021400394,home,1610612740,NOP,88,away,1610612757,POR,114,-26,26,1610612740,1610612757,"(201600, 202337, 201936, 203076, 201950)","(203081, 200746, 202083, 201587, 200777)",False
391,0021400395,home,1610612766,CHA,104,away,1610612762,UTA,86,18,-18,1610612766,1610612762,"(2744, 202689, 201945, 203077, 203469)","(203504, 202324, 202330, 202683, 202692)",False
392,0021400396,home,1610612745,HOU,97,away,1610612737,ATL,104,7,-7,1610612745,1610612737,"(201976, 2772, 2730, 202700, 201935)","(201960, 2594, 203471, 200794, 201143)",True
393,0021400397,home,1610612742,DAL,99,away,1610612759,SAS,93,6,-6,1610612742,1610612759,"(101145, 1717, 200765, 202718, 2199)","(203382, 203937, 2564, 202709, 201158)",False
394,0021400398,home,1610612743,DEN,76,away,1610612754,IND,73,3,-3,1610612743,1610612754,"(201163, 201951, 202389, 202702, 201167)","(201579, 2561, 202388, 201155, 203524)",False
395,0021400399,home,1610612746,LAC,106,away,1610612749,MIL,102,4,-4,1610612746,1610612749,"(2440, 200755, 101108, 201933, 201599)","(202688, 202336, 203507, 203948, 201564)",False
396,0021400400,home,1610612761,TOR,118,away,1610612752,NYK,108,-10,10,1610612761,1610612752,"(200768, 101161, 203082, 201949, 202685)","(203112, 2546, 202332, 203501, 101181)",True
397,0021400401,home,1610612739,CLE,105,away,1610612763,MEM,91,14,-14,1610612739,1610612763,"(2760, 2544, 2034, 201567, 202681)","(202720, 201584, 2419, 201188, 201144)",False
398,0021400402,home,1610612758,SAC,108,away,1610612747,LAL,101,-7,7,1610612758,1610612747,"(200752, 201954, 202326, 201574, 203463)","(977, 101179, 201941, 202334, 202325)",True
399,0021400403,home,1610612751,BKN,110,away,1610612765,DET,105,5,-5,1610612751,1610612765,"(203508, 2207, 708, 203486, 101127)","(202713, 2746, 203083, 203484, 201943)",False
400,0021400404,home,1610612748,MIA,100,away,1610612738,BOS,84,-16,16,1610612748,1610612738,"(2736, 200761, 201596, 202708, 2365)","(203096, 203092, 203935, 202340, 201145)",True
401,0021400405,home,1610612753,ORL,88,away,1610612755,PHI,96,-8,8,1610612753,1610612755,"(202696, 203506, 202699, 203124, 203901)","(203496, 201601, 203960, 203487, 203457)",False
402,0021400406,home,1610612764,WAS,92,away,1610612756,PHX,104,12,-12,1610612764,1610612756,"(101162, 2743, 202322, 203078, 1718)","(201609, 203458, 202339, 202693, 200782)",True
403,0021400407,home,1610612750,MIN,96,away,1610612754,IND,100,4,-4,1610612750,1610612754,"(201152, 203952, 203498, 203476, 203897)","(201579, 2561, 201155, 203524, 201228)",True
404,0021400408,home,1610612760,OKC,99,away,1610612740,NOP,101,2,-2,1610612760,1610612740,"(203500, 201586, 203460, 201566, 203103)","(201600, 202337, 201936, 201950, 203076)",True
405,0021400409,home,1610612766,CHA,110,away,1610612743,DEN,82,28,-28,1610612766,1610612743,"(2744, 202689, 201945, 203077, 203469)","(201163, 201951, 202389, 202702, 201167)",False
406,0021400410,home,1610612741,CHI,129,away,1610612761,TOR,120,9,-9,1610612741,1610612761,"(2200, 2399, 201149, 202710, 201565)","(200768, 101161, 203082, 202685, 201949)",False
407,0021400411,home,1610612745,HOU,110,away,1610612757,POR,95,15,-15,1610612745,1610612757,"(201976, 2772, 2730, 202700, 201935)","(203081, 202083, 201587, 203086, 200777)",False
408,0021400412,home,1610612763,MEM,91,away,1610612762,UTA,97,-6,6,1610612763,1610612762,"(201584, 201585, 2419, 201144, 201188)","(203504, 202324, 202330, 202683, 202692)",False
409,0021400413,home,1610612742,DAL,102,away,1610612737,ATL,105,3,-3,1610612742,1610612737,"(202718, 101145, 1717, 200765, 2199)","(201960, 2594, 201143, 200794, 203471)",True
410,0021400414,home,1610612759,SAS,125,away,1610612746,LAC,118,-7,7,1610612759,1610612746,"(201168, 203937, 1495, 201980, 2225)","(2440, 200755, 101108, 201933, 201599)",True
411,0021400415,home,1610612744,GSW,128,away,1610612758,SAC,108,20,-20,1610612744,1610612758,"(201939, 203105, 202691, 203084, 203110)","(200752, 201954, 202326, 201574, 203463)",False
412,0021400416,home,1610612739,CLE,125,away,1610612750,MIN,104,21,-21,1610612739,1610612750,"(2760, 2544, 2034, 201567, 202681)","(201152, 203952, 203498, 203476, 203897)",False
413,0021400417,home,1610612754,IND,96,away,1610612740,NOP,84,12,-12,1610612754,1610612740,"(2561, 201155, 201579, 203524, 201228)","(201600, 202337, 201936, 203076, 201950)",False
414,0021400418,home,1610612753,ORL,100,away,1610612738,BOS,95,-5,5,1610612753,1610612738,"(202696, 203506, 202699, 203124, 203901)","(203096, 203092, 202340, 2749, 201145)",True
415,0021400419,home,1610612764,WAS,91,away,1610612741,CHI,99,8,-8,1610612764,1610612741,"(101162, 202322, 203078, 1718, 2743)","(2200, 2399, 201565, 202710, 201149)",True
416,0021400420,home,1610612737,ATL,107,away,1610612746,LAC,104,3,-3,1610612737,1610612746,"(201960, 2594, 201143, 200794, 203471)","(2440, 200755, 101108, 201933, 201599)",False
417,0021400421,home,1610612751,BKN,102,away,1610612743,DEN,96,6,-6,1610612751,1610612743,"(203508, 2207, 708, 203486, 101127)","(201163, 201951, 202389, 202702, 201167)",False
418,0021400422,home,1610612748,MIA,87,away,1610612755,PHI,91,-4,4,1610612748,1610612755,"(2736, 200761, 201596, 2548, 2365)","(203496, 201601, 203960, 203487, 203457)",False
419,0021400423,home,1610612749,MIL,101,away,1610612766,CHA,108,7,-7,1610612749,1610612766,"(202688, 202336, 203507, 203948, 201564)","(2744, 202689, 201945, 203077, 203469)",True
420,0021400424,home,1610612760,OKC,111,away,1610612757,POR,115,-4,4,1610612760,1610612757,"(203500, 201586, 203460, 201566, 203103)","(203081, 200746, 203459, 202083, 200777)",False
421,0021400425,home,1610612756,PHX,124,away,1610612742,DAL,115,-9,9,1610612756,1610612742,"(201609, 203458, 202339, 202693, 200782)","(202718, 101145, 1717, 200765, 2199)",True
422,0021400426,home,1610612747,LAL,115,away,1610612744,GSW,105,-10,10,1610612747,1610612744,"(201961, 101179, 201941, 202334, 202325)","(201939, 203105, 202691, 203084, 203110)",True
423,0021400427,home,1610612752,NYK,91,away,1610612764,WAS,102,-11,11,1610612752,1610612764,"(2546, 2223, 101181, 2405, 203501)","(101162, 2403, 202322, 203078, 1718)",False
424,0021400428,home,1610612759,SAS,106,away,1610612760,OKC,114,8,-8,1610612759,1610612760,"(201168, 2225, 201980, 201158, 1495)","(203500, 201586, 203460, 201566, 203103)",True
425,0021400429,home,1610612748,MIA,101,away,1610612739,CLE,91,-10,10,1610612748,1610612739,"(2736, 200761, 201596, 2548, 2365)","(2544, 202681, 1890, 2034, 201567)",True
426,0021400430,home,1610612741,CHI,113,away,1610612747,LAL,93,20,-20,1610612741,1610612747,"(2200, 2399, 201565, 202710, 201149)","(201961, 101179, 202325, 202334, 201941)",False
427,0021400431,home,1610612746,LAC,100,away,1610612744,GSW,86,-14,14,1610612746,1610612744,"(2440, 200755, 101108, 201933, 201599)","(201939, 201578, 202691, 203084, 203110)",True
428,0021400432,home,1610612738,BOS,107,away,1610612751,BKN,109,2,-2,1610612738,1610612751,"(203096, 203092, 203935, 202340, 201145)","(708, 2207, 203508, 203486, 101127)",True
429,0021400433,home,1610612753,ORL,89,away,1610612739,CLE,98,9,-9,1610612753,1610612739,"(202696, 203506, 202699, 203124, 203901)","(2544, 203521, 2034, 202684, 201567)",True
430,0021400434,home,1610612737,ATL,77,away,1610612749,MIL,107,-30,30,1610612737,1610612749,"(201952, 201960, 2594, 200794, 201143)","(202688, 203088, 203507, 203948, 2585)",False
431,0021400435,home,1610612765,DET,119,away,1610612754,IND,109,10,-10,1610612765,1610612754,"(202328, 202713, 203083, 203484, 201943)","(201579, 2561, 201155, 203524, 201228)",False
432,0021400436,home,1610612763,MEM,111,away,1610612745,HOU,117,6,-6,1610612763,1610612745,"(202720, 201584, 2754, 201144, 201188)","(201976, 2772, 2730, 202700, 201935)",True
433,0021400437,home,1610612740,NOP,97,away,1610612759,SAS,90,7,-7,1610612740,1610612759,"(201600, 202337, 201936, 203076, 201950)","(201168, 203937, 201980, 202709, 1495)",False
434,0021400438,home,1610612760,OKC,98,away,1610612766,CHA,75,-23,23,1610612760,1610612766,"(203500, 201586, 203460, 201566, 203103)","(2744, 202689, 201945, 203077, 203469)",True
435,0021400439,home,1610612742,DAL,102,away,1610612747,LAL,98,4,-4,1610612742,1610612747,"(202718, 101145, 1717, 200765, 2199)","(201961, 101179, 201941, 202334, 202325)",False
436,0021400440,home,1610612743,DEN,106,away,1610612750,MIN,102,4,-4,1610612743,1610612750,"(201163, 201951, 202389, 202702, 201167)","(201152, 203952, 203498, 203476, 203897)",False
437,0021400441,home,1610612757,POR,114,away,1610612755,PHI,93,-21,21,1610612757,1610612755,"(203080, 203081, 202083, 201587, 200777)","(203496, 201601, 203960, 203487, 203457)",True
438,0021400442,home,1610612758,SAC,106,away,1610612756,PHX,115,9,-9,1610612758,1610612756,"(200752, 201954, 2501, 201574, 203463)","(201609, 203458, 202339, 202693, 200782)",True
439,0021400443,home,1610612746,LAC,98,away,1610612761,TOR,110,-12,12,1610612746,1610612761,"(2440, 200755, 101108, 201933, 201599)","(200768, 101161, 203082, 201949, 202685)",False
440,0021400444,home,1610612766,CHA,94,away,1610612753,ORL,102,-8,8,1610612766,1610612753,"(2744, 202689, 201945, 203077, 203469)","(202696, 203506, 202699, 203124, 203901)",False
441,0021400445,home,1610612764,WAS,101,away,1610612738,BOS,88,-13,13,1610612764,1610612738,"(101162, 2403, 202322, 203078, 1718)","(203096, 203092, 203935, 202340, 201145)",True
442,0021400446,home,1610612748,MIA,95,away,1610612763,MEM,103,8,-8,1610612748,1610612763,"(2736, 200761, 201596, 2548, 2365)","(202720, 201584, 2754, 201144, 201188)",True
443,0021400447,home,1610612741,CHI,107,away,1610612740,NOP,100,7,-7,1610612741,1610612740,"(2200, 2399, 201565, 202710, 201149)","(201600, 202337, 201936, 203076, 201950)",False
444,0021400448,home,1610612751,BKN,85,away,1610612754,IND,110,-25,25,1610612751,1610612754,"(708, 2207, 203508, 203486, 101127)","(201579, 2561, 201588, 201155, 203524)",False
445,0021400449,home,1610612749,MIL,85,away,1610612737,ATL,90,5,-5,1610612749,1610612737,"(202688, 203088, 203507, 203948, 2585)","(201952, 201960, 2594, 200794, 201143)",True
446,0021400450,home,1610612762,UTA,88,away,1610612755,PHI,71,-17,17,1610612762,1610612755,"(203504, 202330, 202683, 202324, 203918)","(203496, 203457, 203960, 203156, 203487)",True
447,0021400451,home,1610612758,SAC,135,away,1610612752,NYK,129,-6,6,1610612758,1610612752,"(200752, 201954, 202326, 201574, 203463)","(201160, 2546, 202332, 203501, 101181)",True
448,0021400452,home,1610612744,GSW,110,away,1610612750,MIN,97,13,-13,1610612744,1610612750,"(201939, 201578, 202691, 203084, 203110)","(201152, 203952, 203498, 203476, 203897)",False
449,0021400453,home,1610612739,CLE,80,away,1610612765,DET,103,-23,23,1610612739,1610612765,"(2544, 203521, 2034, 202684, 201567)","(202328, 202713, 203083, 203484, 201943)",False
450,0021400454,home,1610612759,SAS,110,away,1610612745,HOU,106,-4,4,1610612759,1610612745,"(201168, 201980, 202709, 201158, 1495)","(201976, 2730, 2772, 2746, 201935)",True
451,0021400455,home,1610612742,DAL,112,away,1610612760,OKC,107,5,-5,1610612742,1610612760,"(101145, 200826, 1717, 202718, 200765)","(203500, 201586, 203460, 201566, 203103)",False
452,0021400456,home,1610612757,POR,101,away,1610612752,NYK,79,-22,22,1610612757,1610612752,"(203080, 203081, 202083, 201587, 200777)","(201160, 2546, 202332, 203501, 101181)",True
453,0021400457,home,1610612743,DEN,102,away,1610612761,TOR,116,-14,14,1610612743,1610612761,"(201163, 201951, 202389, 202702, 201167)","(200768, 101161, 203082, 201949, 202685)",False
454,0021400458,home,1610612747,LAL,107,away,1610612756,PHX,116,-9,9,1610612747,1610612756,"(977, 101179, 202325, 202334, 201941)","(201609, 203458, 202339, 202693, 200782)",False
455,0021400459,home,1610612766,CHA,94,away,1610612749,MIL,104,-10,10,1610612766,1610612749,"(2744, 202689, 201945, 203077, 203469)","(202688, 2585, 203114, 203507, 203948)",False
456,0021400460,home,1610612754,IND,90,away,1610612741,CHI,92,2,-2,1610612754,1610612741,"(201579, 2561, 201588, 201155, 203524)","(2200, 2399, 201565, 202710, 201149)",True
457,0021400461,home,1610612751,BKN,107,away,1610612758,SAC,99,8,-8,1610612751,1610612758,"(203508, 2207, 708, 203486, 101127)","(200752, 201954, 202326, 201574, 203463)",False
458,0021400462,home,1610612748,MIA,101,away,1610612753,ORL,102,-1,1,1610612748,1610612753,"(2736, 201596, 2547, 2548, 2365)","(202696, 203506, 202699, 203124, 203901)",False
459,0021400463,home,1610612745,HOU,103,away,1610612764,WAS,104,-1,1,1610612745,1610612764,"(201976, 2746, 2772, 2730, 201935)","(101162, 2403, 202322, 203078, 1718)",False
460,0021400464,home,1610612746,LAC,101,away,1610612762,UTA,97,4,-4,1610612746,1610612762,"(2440, 200755, 101108, 201933, 201599)","(203504, 202330, 202683, 202324, 203918)",False
461,0021400465,home,1610612753,ORL,86,away,1610612765,DET,109,23,-23,1610612753,1610612765,"(202696, 203506, 202699, 203124, 203901)","(202328, 202713, 203083, 203484, 201943)",True
462,0021400466,home,1610612737,ATL,109,away,1610612739,CLE,101,8,-8,1610612737,1610612739,"(201952, 201960, 2594, 200794, 203544)","(203521, 2034, 201567, 202684, 202681)",False
463,0021400467,home,1610612741,CHI,82,away,1610612751,BKN,96,14,-14,1610612741,1610612751,"(2200, 201565, 201149, 202710, 2399)","(203508, 2207, 201572, 203486, 101127)",True
464,0021400468,home,1610612763,MEM,95,away,1610612759,SAS,87,8,-8,1610612763,1610612759,"(202720, 201584, 2754, 201144, 201188)","(201168, 201980, 202709, 201158, 1495)",False
465,0021400469,home,1610612740,NOP,110,away,1610612756,PHX,106,4,-4,1610612740,1610612756,"(201600, 202337, 201936, 203076, 201950)","(201609, 203458, 202339, 202693, 200782)",False
466,0021400470,home,1610612742,DAL,114,away,1610612764,WAS,87,27,-27,1610612742,1610612764,"(202718, 101145, 1717, 200765, 2199)","(101162, 2403, 202322, 203078, 1718)",False
467,0021400471,home,1610612743,DEN,103,away,1610612747,LAL,111,-8,8,1610612743,1610612747,"(201163, 201951, 202389, 202702, 201167)","(977, 101179, 201941, 202334, 202325)",False
468,0021400472,home,1610612762,UTA,100,away,1610612750,MIN,94,-6,6,1610612762,1610612750,"(203504, 202330, 202683, 202324, 203918)","(201152, 203952, 203498, 203476, 203897)",True
469,0021400473,home,1610612757,POR,102,away,1610612761,TOR,97,5,-5,1610612757,1610612761,"(200777, 200746, 202083, 201587, 203081)","(200768, 101161, 203082, 201949, 202685)",False
470,0021400474,home,1610612744,GSW,126,away,1610612755,PHI,86,40,-40,1610612744,1610612755,"(201939, 201578, 202691, 203084, 203110)","(203496, 203457, 203960, 203156, 203487)",False
471,0021400475,home,1610612738,BOS,106,away,1610612758,SAC,84,22,-22,1610612738,1610612758,"(203096, 203092, 202323, 202340, 201145)","(200752, 201954, 200797, 202326, 203463)",False
472,0021400476,home,1610612754,IND,106,away,1610612748,MIA,95,11,-11,1610612754,1610612748,"(201579, 2561, 201588, 201155, 203524)","(2736, 201596, 2547, 2548, 2365)",False
473,0021400477,home,1610612746,LAC,99,away,1610612752,NYK,78,21,-21,1610612746,1610612752,"(2440, 200755, 101108, 201933, 201599)","(201160, 2546, 202332, 203501, 101181)",False
474,0021400478,home,1610612745,HOU,102,away,1610612766,CHA,83,-19,19,1610612745,1610612766,"(201976, 2730, 2772, 2746, 201935)","(202689, 201945, 202687, 203077, 203469)",True
475,0021400479,home,1610612739,CLE,80,away,1610612749,MIL,96,-16,16,1610612739,1610612749,"(203521, 2034, 202681, 202684, 2217)","(202688, 2585, 203114, 203507, 203948)",False
476,0021400480,home,1610612760,OKC,137,away,1610612756,PHX,134,3,-3,1610612760,1610612756,"(203500, 201586, 203460, 201566, 201142)","(201609, 203458, 202339, 202693, 200782)",False
477,0021400481,home,1610612759,SAS,95,away,1610612740,NOP,93,-2,2,1610612759,1610612740,"(203937, 201980, 202709, 2588, 1495)","(201600, 202337, 201936, 203076, 201950)",True
478,0021400482,home,1610612741,CHI,106,away,1610612743,DEN,101,5,-5,1610612741,1610612743,"(2200, 2399, 201565, 202710, 201149)","(201163, 201951, 202389, 202702, 201167)",False
479,0021400483,home,1610612750,MIN,107,away,1610612758,SAC,110,-3,3,1610612750,1610612758,"(201152, 203952, 203498, 203476, 203897)","(200752, 201954, 202682, 202326, 203463)",False
480,0021400484,home,1610612766,CHA,87,away,1610612739,CLE,91,-4,4,1610612766,1610612739,"(202689, 201945, 202687, 203077, 203469)","(203521, 2034, 201567, 202684, 202681)",False
481,0021400485,home,1610612753,ORL,98,away,1610612751,BKN,100,2,-2,1610612753,1610612751,"(202696, 203506, 202699, 203124, 203901)","(203508, 2207, 708, 203486, 101127)",True
482,0021400486,home,1610612738,BOS,101,away,1610612742,DAL,119,-18,18,1610612738,1610612742,"(203096, 203092, 202323, 202340, 201145)","(202718, 101145, 1717, 200765, 2199)",False
483,0021400487,home,1610612752,NYK,81,away,1610612765,DET,97,16,-16,1610612752,1610612765,"(201160, 2747, 202332, 101181, 203143)","(202328, 202713, 203083, 203484, 201943)",True
484,0021400488,home,1610612740,NOP,111,away,1610612745,HOU,83,-28,28,1610612740,1610612745,"(201600, 202337, 201936, 203076, 201950)","(201976, 2730, 2772, 2746, 201935)",True
485,0021400489,home,1610612760,OKC,109,away,1610612764,WAS,102,7,-7,1610612760,1610612764,"(203500, 201586, 203460, 201566, 201142)","(101162, 2403, 202322, 203078, 1718)",False
486,0021400490,home,1610612749,MIL,91,away,1610612754,IND,94,3,-3,1610612749,1610612754,"(202688, 2585, 203114, 203507, 203948)","(201579, 2561, 202388, 201155, 203524)",True
487,0021400491,home,1610612756,PHX,112,away,1610612755,PHI,96,-16,16,1610612756,1610612755,"(201609, 203458, 202339, 202693, 200782)","(203496, 201601, 203487, 203909, 203457)",True
488,0021400492,home,1610612762,UTA,92,away,1610612737,ATL,98,6,-6,1610612762,1610612737,"(203504, 202330, 202683, 202324, 203565)","(201952, 201960, 2594, 200794, 201143)",True
489,0021400493,home,1610612744,GSW,126,away,1610612761,TOR,105,21,-21,1610612744,1610612761,"(201939, 201578, 202691, 203084, 203110)","(200768, 101161, 203082, 202685, 202361)",False
490,0021400494,home,1610612747,LAL,106,away,1610612763,MEM,109,-3,3,1610612747,1610612763,"(977, 101179, 202325, 202334, 201941)","(202720, 201584, 2754, 201144, 201188)",False
491,0021400495,home,1610612753,ORL,90,away,1610612766,CHA,98,8,-8,1610612753,1610612766,"(202696, 203506, 202699, 203124, 203901)","(202689, 201945, 202687, 203077, 203469)",True
492,0021400496,home,1610612741,CHI,109,away,1610612738,BOS,104,-5,5,1610612741,1610612738,"(2200, 201565, 201149, 2550, 202703)","(203096, 203092, 202323, 202340, 201145)",True
493,0021400497,home,1610612745,HOU,115,away,1610612748,MIA,79,36,-36,1610612745,1610612748,"(201976, 2772, 2730, 202700, 201935)","(2736, 201596, 2547, 2548, 2365)",False
494,0021400498,home,1610612750,MIN,89,away,1610612762,UTA,101,-12,12,1610612750,1610612762,"(201152, 203952, 203498, 203476, 203897)","(203504, 203497, 202330, 202324, 204060)",False
495,0021400499,home,1610612759,SAS,101,away,1610612764,WAS,92,9,-9,1610612759,1610612764,"(201168, 201980, 202709, 201158, 1495)","(101162, 2403, 202322, 203078, 1718)",False
496,0021400500,home,1610612743,DEN,114,away,1610612763,MEM,85,29,-29,1610612743,1610612763,"(201163, 201951, 202389, 202702, 201167)","(202720, 201584, 2754, 201144, 201188)",False
497,0021400501,home,1610612757,POR,107,away,1610612737,ATL,115,8,-8,1610612757,1610612737,"(200777, 200746, 202083, 201587, 203081)","(201952, 201960, 2594, 200794, 201143)",True
498,0021400502,home,1610612746,LAC,127,away,1610612755,PHI,91,36,-36,1610612746,1610612755,"(2440, 200755, 101108, 201933, 201599)","(203496, 201601, 203100, 203909, 203457)",False
499,0021400503,home,1610612739,CLE,90,away,1610612742,DAL,109,-19,19,1610612739,1610612742,"(203521, 2034, 201567, 202684, 202681)","(202718, 101145, 1717, 200765, 2199)",False
500,0021400504,home,1610612765,DET,114,away,1610612758,SAC,95,19,-19,1610612765,1610612758,"(202328, 202713, 203083, 203484, 201943)","(200752, 201954, 202326, 201574, 203463)",False
501,0021400505,home,1610612748,MIA,88,away,1610612751,BKN,84,-4,4,1610612748,1610612751,"(2736, 201596, 2547, 2548, 2365)","(203508, 2207, 708, 203486, 101127)",True
502,0021400506,home,1610612752,NYK,82,away,1610612749,MIL,95,13,-13,1610612752,1610612749,"(203112, 2747, 202332, 203501, 101181)","(202688, 2585, 203114, 203507, 203948)",True
503,0021400507,home,1610612756,PHX,125,away,1610612761,TOR,109,16,-16,1610612756,1610612761,"(201609, 203458, 202339, 202693, 200782)","(200768, 101161, 203082, 202685, 202361)",False
504,0021400508,home,1610612747,LAL,88,away,1610612754,IND,87,-1,1,1610612747,1610612754,"(977, 101179, 201941, 202334, 202325)","(201579, 2561, 202388, 201155, 203524)",True
505,0021400509,home,1610612755,PHI,95,away,1610612739,CLE,92,-3,3,1610612755,1610612739,"(203496, 203457, 203156, 203909, 203487)","(203521, 2034, 202684, 203925, 201567)",True
506,0021400510,home,1610612738,BOS,95,away,1610612766,CHA,104,-9,9,1610612738,1610612766,"(203096, 203092, 202323, 202340, 201145)","(202689, 201945, 202687, 203077, 203469)",False
507,0021400511,home,1610612751,BKN,88,away,1610612742,DAL,96,-8,8,1610612751,1610612742,"(203508, 2207, 201572, 203486, 101127)","(101145, 200765, 1717, 202718, 2199)",False
508,0021400512,home,1610612741,CHI,114,away,1610612745,HOU,105,9,-9,1610612741,1610612745,"(2200, 2550, 201565, 202710, 201149)","(201976, 2772, 2730, 202700, 201935)",False
509,0021400513,home,1610612763,MEM,105,away,1610612752,NYK,83,22,-22,1610612763,1610612752,"(201584, 201144, 2754, 201188, 203950)","(201160, 203499, 202332, 203501, 101181)",False
510,0021400514,home,1610612750,MIN,101,away,1610612743,DEN,110,9,-9,1610612750,1610612743,"(201152, 203952, 203498, 203476, 2590)","(201163, 201951, 202389, 202702, 201167)",True
511,0021400515,home,1610612740,NOP,85,away,1610612764,WAS,92,-7,7,1610612740,1610612764,"(201600, 202337, 203076, 201950, 201569)","(101162, 2403, 202322, 203078, 1718)",False
512,0021400516,home,1610612762,UTA,101,away,1610612754,IND,105,4,-4,1610612762,1610612754,"(203497, 202330, 202324, 203957, 204060)","(201579, 2561, 201155, 203524, 201228)",True
513,0021400517,home,1610612757,POR,98,away,1610612747,LAL,94,-4,4,1610612757,1610612747,"(203081, 200746, 202083, 201587, 2549)","(201961, 101179, 201941, 202334, 203527)",True
514,0021400518,home,1610612744,GSW,117,away,1610612760,OKC,91,26,-26,1610612744,1610612760,"(201939, 201578, 202691, 203084, 203110)","(203500, 201586, 203460, 201566, 201142)",False
515,0021400519,home,1610612746,LAC,98,away,1610612737,ATL,107,9,-9,1610612746,1610612737,"(2440, 200755, 101108, 201933, 201599)","(201952, 201960, 2594, 200794, 201143)",True
516,0021400520,home,1610612749,MIL,96,away,1610612756,PHX,102,-6,6,1610612749,1610612756,"(202688, 2585, 203114, 203507, 203948)","(201609, 203458, 202339, 202693, 200782)",False
517,0021400521,home,1610612759,SAS,104,away,1610612765,DET,105,1,-1,1610612759,1610612765,"(201168, 2225, 201980, 201158, 1495)","(202328, 202713, 203083, 203484, 201943)",True
518,0021400522,home,1610612766,CHA,98,away,1610612740,NOP,94,4,-4,1610612766,1610612740,"(202689, 201945, 202687, 203077, 203469)","(201600, 201569, 201936, 203076, 201950)",False
519,0021400523,home,1610612739,CLE,93,away,1610612745,HOU,105,-12,12,1610612739,1610612745,"(203521, 2034, 201567, 202684, 202681)","(201976, 2772, 2730, 202700, 201935)",False
520,0021400524,home,1610612755,PHI,77,away,1610612749,MIL,97,20,-20,1610612755,1610612749,"(203496, 203457, 203156, 203909, 203487)","(202688, 2585, 203114, 203507, 203948)",True
521,0021400525,home,1610612764,WAS,101,away,1610612752,NYK,91,-10,10,1610612764,1610612752,"(203490, 2403, 202322, 101162, 203078)","(203112, 101181, 202332, 203501, 203143)",True
522,0021400526,home,1610612737,ATL,96,away,1610612763,MEM,86,10,-10,1610612737,1610612763,"(201952, 201960, 2594, 200794, 201143)","(201584, 201144, 2754, 201188, 203950)",False
523,0021400527,home,1610612751,BKN,81,away,1610612738,BOS,89,-8,8,1610612751,1610612738,"(708, 2207, 203508, 203486, 101127)","(203096, 203092, 202323, 202340, 201145)",False
524,0021400528,home,1610612741,CHI,77,away,1610612762,UTA,97,-20,20,1610612741,1610612762,"(2200, 2550, 201565, 202710, 201149)","(203504, 203497, 202330, 202324, 204060)",False
525,0021400529,home,1610612742,DAL,95,away,1610612765,DET,108,-13,13,1610612742,1610612765,"(101145, 200765, 1717, 202718, 2199)","(202328, 202713, 203083, 203484, 201943)",False
526,0021400530,home,1610612743,DEN,93,away,1610612753,ORL,90,3,-3,1610612743,1610612753,"(203994, 201163, 201951, 202702, 201167)","(202696, 203506, 202699, 203124, 203901)",False
527,0021400531,home,1610612750,MIN,111,away,1610612756,PHX,113,-2,2,1610612750,1610612756,"(201152, 203952, 203498, 203476, 2590)","(201609, 203458, 202339, 202693, 200782)",False
528,0021400532,home,1610612758,SAC,104,away,1610612760,OKC,83,-21,21,1610612758,1610612760,"(200752, 201954, 201574, 202326, 203463)","(203500, 201586, 203460, 201566, 201142)",True
529,0021400533,home,1610612744,GSW,117,away,1610612754,IND,102,15,-15,1610612744,1610612754,"(201939, 201578, 202691, 203084, 203110)","(101139, 2561, 201579, 203524, 201228)",False
530,0021400534,home,1610612746,LAC,114,away,1610612747,LAL,89,25,-25,1610612746,1610612747,"(2440, 200755, 101108, 201933, 201599)","(201961, 202391, 201941, 202334, 977)",False
531,0021400535,home,1610612761,TOR,95,away,1610612766,CHA,103,8,-8,1610612761,1610612766,"(200768, 101161, 203082, 202685, 202361)","(202689, 202687, 101107, 203077, 201945)",True
532,0021400536,home,1610612752,NYK,96,away,1610612745,HOU,120,24,-24,1610612752,1610612745,"(201160, 101181, 202332, 203501, 203143)","(201976, 2772, 2730, 202700, 201935)",True
533,0021400537,home,1610612757,POR,99,away,1610612748,MIA,83,-16,16,1610612757,1610612748,"(203081, 200746, 202083, 201587, 2549)","(2736, 201596, 2547, 2548, 2365)",True
534,0021400538,home,1610612754,IND,107,away,1610612738,BOS,103,-4,4,1610612754,1610612738,"(201579, 2561, 201155, 203524, 201228)","(203096, 202340, 202323, 203092, 203109)",True
535,0021400539,home,1610612751,BKN,88,away,1610612755,PHI,90,-2,2,1610612751,1610612755,"(203508, 2207, 201572, 203486, 101127)","(203496, 201601, 203487, 203156, 203457)",False
536,0021400540,home,1610612765,DET,103,away,1610612737,ATL,106,3,-3,1610612765,1610612737,"(202328, 202713, 203083, 203484, 201943)","(201952, 201960, 2594, 200794, 201143)",True
537,0021400541,home,1610612740,NOP,106,away,1610612763,MEM,95,-11,11,1610612740,1610612763,"(201600, 201569, 203076, 201950, 201967)","(2216, 201584, 2754, 201144, 201188)",True
538,0021400542,home,1610612760,OKC,99,away,1610612762,UTA,94,5,-5,1610612760,1610612762,"(203500, 201586, 203460, 201566, 201142)","(203504, 203497, 202330, 202324, 204060)",False
539,0021400543,home,1610612764,WAS,102,away,1610612741,CHI,86,-16,16,1610612764,1610612741,"(101162, 2403, 202322, 1718, 203078)","(202710, 2200, 201565, 2550, 201149)",True
540,0021400544,home,1610612749,MIL,98,away,1610612750,MIN,84,14,-14,1610612749,1610612750,"(202688, 2585, 203114, 203507, 203948)","(201152, 203952, 203498, 203476, 203897)",False
541,0021400545,home,1610612759,SAS,100,away,1610612756,PHX,95,-5,5,1610612759,1610612756,"(201168, 2225, 201980, 201158, 1495)","(201609, 203458, 202339, 202693, 200782)",True
542,0021400546,home,1610612758,SAC,108,away,1610612743,DEN,118,10,-10,1610612758,1610612743,"(200752, 201954, 202326, 201574, 203463)","(203994, 201951, 201589, 202702, 201167)",True
543,0021400547,home,1610612744,GSW,112,away,1610612739,CLE,94,-18,18,1610612744,1610612739,"(201939, 201578, 202691, 203084, 203110)","(202681, 2034, 2747, 202684, 201567)",True
544,0021400548,home,1610612747,LAL,101,away,1610612753,ORL,84,17,-17,1610612747,1610612753,"(201961, 101179, 201941, 202334, 203527)","(202696, 203506, 202699, 203124, 203901)",False
545,0021400549,home,1610612752,NYK,82,away,1610612766,CHA,110,28,-28,1610612752,1610612766,"(201160, 203921, 202332, 203501, 101181)","(202689, 201945, 202687, 203077, 203469)",True
546,0021400550,home,1610612746,LAC,120,away,1610612742,DAL,100,-20,20,1610612746,1610612742,"(2440, 200755, 101108, 201933, 201599)","(202718, 101145, 1717, 200765, 2199)",True
547,0021400551,home,1610612765,DET,98,away,1610612751,BKN,93,-5,5,1610612765,1610612751,"(202328, 202713, 203083, 203484, 201943)","(202711, 708, 2207, 203486, 101127)",True
548,0021400552,home,1610612755,PHI,93,away,1610612754,IND,92,-1,1,1610612755,1610612754,"(203496, 201601, 203487, 203909, 203457)","(201579, 201228, 201155, 203524, 2561)",True
549,0021400553,home,1610612761,TOR,109,away,1610612738,BOS,96,-13,13,1610612761,1610612738,"(200768, 101161, 203082, 201949, 202685)","(203096, 203092, 202323, 202340, 203109)",True
550,0021400554,home,1610612741,CHI,95,away,1610612749,MIL,87,8,-8,1610612741,1610612749,"(2200, 201149, 2550, 202710, 203503)","(202688, 2585, 203114, 203507, 203948)",False
551,0021400555,home,1610612745,HOU,97,away,1610612762,UTA,82,15,-15,1610612745,1610612762,"(201976, 2772, 2730, 202700, 201935)","(203504, 203497, 202330, 202324, 204060)",False
552,0021400556,home,1610612750,MIN,93,away,1610612759,SAS,108,-15,15,1610612750,1610612759,"(201152, 203952, 201978, 203476, 2590)","(201948, 1495, 2564, 201980, 2225)",False
553,0021400557,home,1610612757,POR,103,away,1610612753,ORL,92,-11,11,1610612757,1610612753,"(203081, 200746, 202083, 201587, 2549)","(202696, 101112, 203906, 203506, 203901)",True
554,0021400558,home,1610612737,ATL,120,away,1610612764,WAS,89,31,-31,1610612737,1610612764,"(201952, 201960, 2594, 200794, 201143)","(101162, 2403, 202322, 203078, 1718)",False
555,0021400559,home,1610612746,LAC,90,away,1610612748,MIA,104,-14,14,1610612746,1610612748,"(2440, 200755, 101108, 201933, 201599)","(2736, 201596, 2547, 2548, 2365)",False
556,0021400560,home,1610612763,MEM,122,away,1610612756,PHX,110,12,-12,1610612763,1610612756,"(2216, 201584, 2754, 201144, 201188)","(201609, 203458, 202339, 202693, 200782)",False
557,0021400561,home,1610612758,SAC,103,away,1610612739,CLE,84,-19,19,1610612758,1610612739,"(200752, 201954, 202326, 201574, 203463)","(202681, 2034, 2747, 202389, 201567)",True
558,0021400562,home,1610612747,LAL,94,away,1610612757,POR,106,-12,12,1610612747,1610612757,"(201961, 101179, 202325, 202334, 201941)","(203081, 200746, 202083, 201587, 2549)",False
559,0021400563,home,1610612738,BOS,108,away,1610612740,NOP,100,8,-8,1610612738,1610612740,"(203096, 202340, 202323, 203092, 203109)","(201600, 201569, 203076, 201950, 201967)",False
560,0021400564,home,1610612751,BKN,99,away,1610612745,HOU,113,-14,14,1610612751,1610612745,"(202711, 708, 2207, 203486, 101127)","(201976, 2772, 2730, 202700, 201935)",False
561,0021400565,home,1610612761,TOR,111,away,1610612765,DET,114,3,-3,1610612761,1610612765,"(200768, 101161, 203082, 201949, 202685)","(202328, 202713, 203083, 203484, 201943)",True
562,0021400566,home,1610612741,CHI,114,away,1610612753,ORL,121,-7,7,1610612741,1610612753,"(2200, 201565, 201149, 202710, 203503)","(202696, 101112, 203906, 203506, 203901)",False
563,0021400567,home,1610612754,IND,101,away,1610612750,MIN,110,-9,9,1610612754,1610612750,"(101139, 2561, 201579, 203524, 201228)","(201152, 203952, 201978, 203476, 2590)",False
564,0021400568,home,1610612755,PHI,87,away,1610612737,ATL,105,18,-18,1610612755,1610612737,"(203496, 201601, 203487, 203909, 203457)","(203488, 2594, 201143, 200757, 203471)",True
565,0021400569,home,1610612764,WAS,101,away,1610612759,SAS,93,-8,8,1610612764,1610612759,"(101162, 2403, 202322, 203078, 1718)","(201168, 2225, 201948, 201980, 1495)",True
566,0021400570,home,1610612756,PHX,107,away,1610612739,CLE,100,-7,7,1610612756,1610612739,"(201609, 203458, 202339, 202693, 200782)","(2544, 202681, 2747, 202389, 201567)",True
567,0021400571,home,1610612762,UTA,105,away,1610612744,GSW,116,11,-11,1610612762,1610612744,"(203504, 204060, 202330, 202683, 202324)","(201939, 101106, 202691, 203084, 203110)",True
568,0021400572,home,1610612758,SAC,104,away,1610612742,DAL,108,4,-4,1610612758,1610612742,"(200752, 201954, 202326, 201574, 203463)","(202718, 101145, 1717, 200765, 2199)",True
569,0021400573,home,1610612747,LAL,75,away,1610612748,MIA,78,-3,3,1610612747,1610612748,"(977, 101179, 201941, 202334, 202325)","(2736, 201596, 2547, 2548, 2365)",False
570,0021400574,home,1610612766,CHA,93,away,1610612759,SAS,98,-5,5,1610612766,1610612759,"(202689, 201945, 202687, 203077, 203469)","(2225, 201948, 201980, 2588, 1495)",False
571,0021400575,home,1610612753,ORL,120,away,1610612745,HOU,113,-7,7,1610612753,1610612745,"(202696, 101112, 203906, 203506, 203901)","(201976, 2772, 2730, 202700, 201935)",True
572,0021400576,home,1610612751,BKN,92,away,1610612763,MEM,103,-11,11,1610612751,1610612763,"(202711, 201572, 2207, 203486, 101127)","(2216, 201584, 2754, 201144, 201188)",False
573,0021400577,home,1610612765,DET,94,away,1610612740,NOP,105,-11,11,1610612765,1610612740,"(202328, 202713, 203083, 203484, 201943)","(201600, 201569, 201936, 203076, 201967)",False
574,0021400578,home,1610612761,TOR,100,away,1610612755,PHI,84,-16,16,1610612761,1610612755,"(200768, 101161, 203082, 202685, 201942)","(201601, 203487, 203156, 203909, 203457)",True
575,0021400579,home,1610612741,CHI,99,away,1610612764,WAS,105,-6,6,1610612741,1610612764,"(2200, 201565, 201149, 202710, 203503)","(101162, 2403, 202322, 203078, 1718)",False
576,0021400580,home,1610612738,BOS,91,away,1610612737,ATL,105,14,-14,1610612738,1610612737,"(203096, 203092, 202323, 202340, 203109)","(201952, 201960, 200794, 200757, 203544)",True
577,0021400581,home,1610612743,DEN,114,away,1610612742,DAL,107,-7,7,1610612743,1610612742,"(203994, 201163, 201951, 202702, 201167)","(101145, 2210, 202962, 202718, 101109)",True
578,0021400582,home,1610612744,GSW,104,away,1610612748,MIA,89,15,-15,1610612744,1610612748,"(201939, 101106, 202691, 203084, 203110)","(2736, 202355, 201596, 203894, 2547)",False
579,0021400583,home,1610612757,POR,94,away,1610612746,LAC,100,6,-6,1610612757,1610612746,"(203081, 200746, 202083, 201587, 2549)","(2440, 200755, 101108, 201933, 201599)",True
580,0021400584,home,1610612745,HOU,112,away,1610612760,OKC,101,11,-11,1610612745,1610612760,"(201976, 2772, 2730, 202700, 201935)","(203500, 201586, 203460, 201566, 201142)",False
581,0021400585,home,1610612749,MIL,95,away,1610612752,NYK,79,16,-16,1610612749,1610612752,"(202688, 2585, 203114, 203507, 203948)","(201160, 2546, 203499, 2405, 101181)",False
582,0021400586,home,1610612747,LAL,102,away,1610612739,CLE,109,7,-7,1610612747,1610612739,"(977, 101179, 202325, 202334, 201941)","(2544, 202681, 2747, 202389, 201567)",True
583,0021400587,home,1610612754,IND,96,away,1610612765,DET,98,2,-2,1610612754,1610612765,"(201579, 2561, 201155, 203524, 201228)","(202328, 202713, 203083, 203484, 201943)",True
584,0021400588,home,1610612753,ORL,96,away,1610612763,MEM,106,10,-10,1610612753,1610612763,"(202696, 101112, 203906, 203506, 203901)","(201584, 2216, 2754, 201188, 2757)",True
585,0021400589,home,1610612755,PHI,96,away,1610612740,NOP,81,-15,15,1610612755,1610612740,"(203496, 201601, 203487, 203909, 203457)","(201600, 201569, 201583, 201936, 201967)",True
586,0021400590,home,1610612764,WAS,80,away,1610612751,BKN,102,22,-22,1610612764,1610612751,"(101162, 2403, 202322, 203078, 1718)","(202711, 708, 2207, 203486, 101127)",True
587,0021400591,home,1610612738,BOS,103,away,1610612741,CHI,119,-16,16,1610612738,1610612741,"(203096, 203092, 202323, 202340, 203109)","(2200, 201565, 202710, 2550, 201959)",False
588,0021400592,home,1610612761,TOR,89,away,1610612737,ATL,110,21,-21,1610612761,1610612737,"(200768, 101161, 203082, 202685, 201942)","(201952, 201960, 2594, 200794, 201143)",True
589,0021400593,home,1610612760,OKC,127,away,1610612744,GSW,115,-12,12,1610612760,1610612744,"(203500, 201586, 203460, 201566, 201142)","(201939, 201578, 202691, 203084, 203110)",True
590,0021400594,home,1610612742,DAL,97,away,1610612743,DEN,89,8,-8,1610612742,1610612743,"(202718, 101145, 1717, 200765, 2199)","(203994, 201163, 201951, 202702, 201167)",False
591,0021400595,home,1610612759,SAS,110,away,1610612757,POR,96,-14,14,1610612759,1610612757,"(201168, 2225, 1495, 201980, 202695)","(203081, 200746, 202083, 201587, 2549)",True
592,0021400596,home,1610612756,PHX,110,away,1610612750,MIN,99,-11,11,1610612756,1610612750,"(201609, 203458, 202339, 202693, 200782)","(201152, 203952, 201978, 203476, 2590)",True
593,0021400597,home,1610612762,UTA,94,away,1610612747,LAL,85,-9,9,1610612762,1610612747,"(203504, 204060, 202330, 202683, 202324)","(201961, 201941, 202325, 202334, 202391)",True
594,0021400598,home,1610612758,SAC,83,away,1610612748,MIA,95,12,-12,1610612758,1610612748,"(202682, 201954, 202326, 201574, 203463)","(2736, 202355, 201596, 203894, 2547)",True
595,0021400599,home,1610612746,LAC,121,away,1610612739,CLE,126,5,-5,1610612746,1610612739,"(2440, 200755, 101108, 201933, 201599)","(2544, 202681, 2747, 202684, 202389)",True
596,0021400600,home,1610612766,CHA,80,away,1610612754,IND,71,9,-9,1610612766,1610612754,"(201945, 202687, 203148, 203077, 203469)","(201579, 2561, 201155, 203524, 201228)",False
597,0021400601,home,1610612765,DET,107,away,1610612755,PHI,89,18,-18,1610612765,1610612755,"(202328, 202713, 203083, 203484, 201943)","(203496, 201601, 203487, 203909, 203457)",False
598,0021400602,home,1610612741,CHI,99,away,1610612737,ATL,107,8,-8,1610612741,1610612737,"(2200, 201565, 202710, 2550, 201959)","(201952, 201960, 2594, 200794, 201143)",True
599,0021400603,home,1610612745,HOU,106,away,1610612744,GSW,131,25,-25,1610612745,1610612744,"(201976, 2772, 2730, 202700, 201935)","(201939, 101106, 202691, 203084, 203110)",True
600,0021400604,home,1610612763,MEM,102,away,1610612757,POR,98,4,-4,1610612763,1610612757,"(2216, 201584, 2754, 201188, 2757)","(203081, 200746, 202083, 201587, 2549)",False
601,0021400605,home,1610612751,BKN,90,away,1610612764,WAS,99,-9,9,1610612751,1610612764,"(202711, 708, 2207, 203486, 101127)","(101162, 2403, 202322, 203078, 1718)",False
602,0021400606,home,1610612743,DEN,105,away,1610612750,MIN,113,-8,8,1610612743,1610612750,"(203994, 201163, 201951, 202702, 201167)","(201152, 203952, 203476, 203133, 2590)",False
603,0021400607,home,1610612758,SAC,108,away,1610612746,LAC,117,9,-9,1610612758,1610612746,"(201954, 200797, 202682, 201574, 203463)","(2440, 200755, 101108, 201933, 201599)",True
604,0021400608,home,1610612761,TOR,93,away,1610612740,NOP,95,2,-2,1610612761,1610612740,"(200768, 101161, 203082, 202685, 201942)","(201600, 201569, 201967, 201936, 201583)",True
605,0021400609,home,1610612753,ORL,99,away,1610612760,OKC,127,28,-28,1610612753,1610612760,"(202696, 101112, 203906, 203506, 203901)","(203500, 201586, 203460, 201566, 201142)",True
606,0021400610,home,1610612759,SAS,89,away,1610612762,UTA,69,20,-20,1610612759,1610612762,"(201168, 2225, 1495, 201980, 202695)","(203504, 202324, 202330, 202683, 204060)",False
607,0021400611,home,1610612766,CHA,105,away,1610612750,MIN,80,25,-25,1610612766,1610612750,"(201945, 202687, 203148, 203077, 203469)","(201152, 203952, 203476, 203133, 2590)",False
608,0021400612,home,1610612764,WAS,111,away,1610612755,PHI,76,-35,35,1610612764,1610612755,"(101162, 2403, 202322, 203078, 1718)","(203496, 203457, 203156, 203909, 203487)",True
609,0021400613,home,1610612737,ATL,93,away,1610612765,DET,82,11,-11,1610612737,1610612765,"(201952, 201960, 2594, 200794, 201143)","(202328, 202713, 203083, 203484, 201943)",False
610,0021400614,home,1610612746,LAC,102,away,1610612738,BOS,93,-9,9,1610612746,1610612738,"(2440, 200755, 101108, 201933, 201599)","(203096, 203092, 202323, 202340, 203109)",True
611,0021400615,home,1610612744,GSW,122,away,1610612743,DEN,79,-43,43,1610612744,1610612743,"(201939, 101106, 202691, 203084, 203110)","(203994, 201163, 201951, 202702, 201167)",True
612,0021400616,home,1610612763,MEM,95,away,1610612742,DAL,103,8,-8,1610612763,1610612742,"(2216, 201584, 2754, 201144, 201188)","(202718, 101145, 1717, 200765, 2199)",True
613,0021400617,home,1610612745,HOU,110,away,1610612754,IND,98,12,-12,1610612745,1610612754,"(201976, 2772, 2730, 202700, 201935)","(201579, 2561, 201155, 203524, 201228)",False
614,0021400618,home,1610612752,NYK,99,away,1610612740,NOP,92,-7,7,1610612752,1610612740,"(201160, 2546, 200811, 101181, 204038)","(201600, 201569, 201583, 201936, 201967)",True
615,0021400619,home,1610612749,MIL,89,away,1610612761,TOR,92,-3,3,1610612749,1610612761,"(202688, 2585, 203114, 203507, 203948)","(200768, 101161, 202349, 201942, 202685)",False
616,0021400620,home,1610612739,CLE,108,away,1610612741,CHI,94,-14,14,1610612739,1610612741,"(2544, 202681, 2747, 202389, 201567)","(2200, 201565, 202710, 2550, 201959)",True
617,0021400621,home,1610612757,POR,98,away,1610612758,SAC,94,4,-4,1610612757,1610612758,"(203081, 200746, 202083, 201587, 2549)","(200752, 201954, 202326, 201574, 203463)",False
618,0021400622,home,1610612756,PHX,115,away,1610612747,LAL,100,-15,15,1610612756,1610612747,"(201609, 203458, 202339, 202693, 200782)","(201961, 201941, 202325, 202334, 202391)",True
619,0021400623,home,1610612748,MIA,86,away,1610612760,OKC,94,-8,8,1610612748,1610612760,"(2736, 201596, 202355, 2548, 2547)","(203500, 201586, 203460, 201566, 201142)",False
620,0021400624,home,1610612743,DEN,99,away,1610612759,SAS,109,-10,10,1610612743,1610612759,"(203994, 201163, 201951, 202702, 201167)","(201168, 2225, 1495, 201980, 202695)",False
621,0021400625,home,1610612766,CHA,78,away,1610612748,MIA,76,2,-2,1610612766,1610612748,"(202689, 201945, 202687, 203077, 203469)","(201596, 101122, 2547, 2548, 2365)",False
622,0021400626,home,1610612739,CLE,106,away,1610612762,UTA,92,14,-14,1610612739,1610612762,"(2544, 202681, 2747, 202389, 201567)","(203504, 204060, 202330, 202683, 202324)",False
623,0021400627,home,1610612755,PHI,91,away,1610612752,NYK,98,7,-7,1610612755,1610612752,"(203496, 203128, 203156, 203909, 203487)","(201160, 2546, 200811, 101181, 204038)",True
624,0021400628,home,1610612737,ATL,110,away,1610612754,IND,91,19,-19,1610612737,1610612754,"(201952, 201960, 2594, 200794, 201143)","(201579, 2561, 201155, 203524, 201228)",False
625,0021400629,home,1610612765,DET,128,away,1610612753,ORL,118,10,-10,1610612765,1610612753,"(202328, 202713, 203083, 203484, 201943)","(202696, 101112, 203906, 203506, 203901)",False
626,0021400630,home,1610612763,MEM,92,away,1610612761,TOR,86,6,-6,1610612763,1610612761,"(2216, 201144, 2754, 201188, 201145)","(200768, 101161, 202349, 201942, 202685)",False
627,0021400631,home,1610612750,MIN,75,away,1610612742,DAL,98,23,-23,1610612750,1610612742,"(201152, 203952, 203476, 203133, 2590)","(101145, 1717, 200765, 202718, 2199)",True
628,0021400632,home,1610612740,NOP,96,away,1610612747,LAL,80,-16,16,1610612740,1610612747,"(201600, 201569, 201936, 203076, 201967)","(977, 101179, 201941, 202334, 202325)",True
629,0021400633,home,1610612764,WAS,103,away,1610612760,OKC,105,2,-2,1610612764,1610612760,"(101162, 2403, 202322, 203078, 1718)","(203500, 201586, 203460, 201566, 201142)",True
630,0021400634,home,1610612756,PHX,118,away,1610612757,POR,113,5,-5,1610612756,1610612757,"(201609, 203458, 202339, 202693, 200782)","(203081, 2748, 202083, 201587, 2549)",False
631,0021400635,home,1610612758,SAC,100,away,1610612751,BKN,103,3,-3,1610612758,1610612751,"(200752, 201954, 202326, 201574, 203463)","(202711, 708, 2207, 203486, 101127)",True
632,0021400636,home,1610612744,GSW,126,away,1610612745,HOU,113,13,-13,1610612744,1610612745,"(201939, 101106, 202691, 203084, 203110)","(201976, 2772, 2730, 202700, 201935)",False
633,0021400637,home,1610612741,CHI,104,away,1610612759,SAS,81,23,-23,1610612741,1610612759,"(2200, 203503, 201565, 202710, 201959)","(201168, 2225, 1495, 201980, 202695)",False
634,0021400638,home,1610612749,MIL,99,away,1610612762,UTA,101,-2,2,1610612749,1610612762,"(202688, 2585, 203114, 203507, 101141)","(203497, 202330, 202683, 204060, 203957)",False
635,0021400639,home,1610612757,POR,89,away,1610612738,BOS,90,1,-1,1610612757,1610612738,"(203080, 203081, 202083, 201587, 2549)","(203096, 101138, 202323, 202340, 203109)",True
636,0021400640,home,1610612746,LAC,123,away,1610612751,BKN,84,-39,39,1610612746,1610612751,"(2440, 200755, 101108, 201933, 201599)","(202711, 201572, 2207, 203486, 101127)",True
637,0021400641,home,1610612755,PHI,86,away,1610612761,TOR,91,-5,5,1610612755,1610612761,"(203496, 201601, 203487, 203909, 203457)","(200768, 101161, 202349, 201942, 202685)",False
638,0021400642,home,1610612737,ATL,103,away,1610612760,OKC,93,10,-10,1610612737,1610612760,"(201952, 201960, 2594, 200794, 201143)","(203500, 201586, 203460, 201566, 201142)",False
639,0021400643,home,1610612739,CLE,129,away,1610612766,CHA,90,-39,39,1610612739,1610612766,"(2544, 202681, 2747, 202389, 201567)","(202689, 201945, 202687, 203077, 203469)",True
640,0021400644,home,1610612748,MIA,89,away,1610612754,IND,87,-2,2,1610612748,1610612754,"(2736, 201596, 2547, 2548, 2365)","(101139, 2561, 201579, 203524, 201228)",True
641,0021400645,home,1610612752,NYK,113,away,1610612753,ORL,106,7,-7,1610612752,1610612753,"(201160, 2546, 200811, 101181, 204038)","(202696, 101112, 203906, 203506, 203901)",False
642,0021400646,home,1610612742,DAL,98,away,1610612741,CHI,102,4,-4,1610612742,1610612741,"(101145, 2199, 200765, 202718, 1717)","(2200, 201149, 201565, 202710, 203503)",True
643,0021400647,home,1610612750,MIN,84,away,1610612740,NOP,92,-8,8,1610612750,1610612740,"(203952, 201152, 203476, 203133, 2590)","(201600, 201569, 201936, 203076, 201967)",False
644,0021400648,home,1610612759,SAS,99,away,1610612747,LAL,85,-14,14,1610612759,1610612747,"(2225, 1495, 201980, 2588, 202695)","(201961, 203903, 201941, 203135, 203527)",True
645,0021400649,home,1610612743,DEN,99,away,1610612738,BOS,100,1,-1,1610612743,1610612738,"(203994, 201163, 2749, 202702, 201167)","(203096, 101138, 202323, 202340, 203109)",True
646,0021400650,home,1610612756,PHX,111,away,1610612745,HOU,113,2,-2,1610612756,1610612745,"(201609, 203458, 202339, 202693, 200782)","(201976, 2772, 2730, 202700, 201935)",True
647,0021400651,home,1610612744,GSW,126,away,1610612758,SAC,101,25,-25,1610612744,1610612758,"(201939, 101106, 202691, 203084, 203110)","(200752, 201954, 202682, 202326, 203463)",False
648,0021400652,home,1610612766,CHA,76,away,1610612752,NYK,71,5,-5,1610612766,1610612752,"(201945, 202687, 203148, 203077, 203469)","(201160, 202498, 200811, 203501, 204038)",False
649,0021400653,home,1610612749,MIL,101,away,1610612765,DET,86,-15,15,1610612749,1610612765,"(202688, 2585, 203114, 203507, 101141)","(202328, 202713, 203083, 203484, 201943)",True
650,0021400654,home,1610612763,MEM,101,away,1610612755,PHI,83,18,-18,1610612763,1610612755,"(201584, 2216, 201144, 201188, 201145)","(203496, 201601, 203487, 203909, 203457)",False
651,0021400655,home,1610612762,UTA,108,away,1610612751,BKN,73,-35,35,1610612762,1610612751,"(204060, 202330, 202683, 202324, 203957)","(202711, 708, 2207, 203486, 101127)",True
652,0021400656,home,1610612757,POR,103,away,1610612764,WAS,96,7,-7,1610612757,1610612764,"(203081, 200746, 202083, 2549, 203459)","(101162, 2403, 202322, 203078, 1718)",False
653,0021400657,home,1610612741,CHI,84,away,1610612748,MIA,96,-12,12,1610612741,1610612748,"(2200, 201565, 201149, 202710, 203503)","(2736, 201596, 2547, 2548, 2365)",False
654,0021400658,home,1610612739,CLE,108,away,1610612760,OKC,98,10,-10,1610612739,1610612760,"(2544, 202681, 2747, 202389, 201567)","(201566, 2570, 203460, 201586, 201142)",False
655,0021400659,home,1610612756,PHX,100,away,1610612746,LAC,120,20,-20,1610612756,1610612746,"(201609, 203458, 202339, 202693, 200782)","(2440, 200755, 101108, 201933, 201599)",True
656,0021400660,home,1610612740,NOP,109,away,1610612742,DAL,106,-3,3,1610612740,1610612742,"(201600, 201569, 201936, 203076, 201967)","(202718, 101145, 1717, 200765, 2199)",True
657,0021400661,home,1610612737,ATL,112,away,1610612750,MIN,100,12,-12,1610612737,1610612750,"(201952, 201960, 2594, 200794, 201143)","(201152, 203952, 203476, 2590, 201593)",False
658,0021400662,home,1610612753,ORL,99,away,1610612754,IND,106,7,-7,1610612753,1610612754,"(202696, 101112, 203506, 203932, 203901)","(201579, 2561, 201155, 203524, 201228)",True
659,0021400663,home,1610612759,SAS,101,away,1610612749,MIL,95,-6,6,1610612759,1610612749,"(2225, 1495, 201980, 2588, 202695)","(202688, 2585, 203114, 203507, 101141)",True
660,0021400664,home,1610612761,TOR,114,away,1610612765,DET,110,-4,4,1610612761,1610612765,"(200768, 101161, 202349, 201942, 202685)","(202328, 202713, 203083, 201571, 203484)",True
661,0021400665,home,1610612744,GSW,114,away,1610612738,BOS,111,-3,3,1610612744,1610612738,"(201939, 101106, 202691, 203084, 203110)","(203096, 101138, 202323, 202340, 203109)",True
662,0021400666,home,1610612743,DEN,115,away,1610612764,WAS,117,-2,2,1610612743,1610612764,"(203994, 201163, 201951, 202702, 201167)","(101162, 2403, 202322, 203078, 1718)",False
663,0021400667,home,1610612747,LAL,87,away,1610612745,HOU,99,12,-12,1610612747,1610612745,"(201961, 203903, 203135, 201941, 203527)","(201976, 2772, 201595, 202700, 201935)",True
664,0021400668,home,1610612751,BKN,106,away,1610612757,POR,96,10,-10,1610612751,1610612757,"(201152, 203900, 101114, 201572, 2207)","(201577, 203468, 203081, 203086, 201167)",False
665,0021400669,home,1610612752,NYK,86,away,1610612758,SAC,124,-38,38,1610612752,1610612758,"(200745, 200811, 203501, 204038, 203921)","(200752, 203492, 202326, 201574, 203463)",False
666,0021400670,home,1610612763,MEM,103,away,1610612753,ORL,94,9,-9,1610612763,1610612753,"(201584, 2216, 201144, 201188, 201145)","(202696, 101112, 203506, 203932, 203901)",False
667,0021400671,home,1610612740,NOP,99,away,1610612755,PHI,74,25,-25,1610612740,1610612755,"(201600, 201936, 203076, 201569, 201967)","(203496, 201601, 203580, 203156, 203457)",False
668,0021400672,home,1610612760,OKC,92,away,1610612750,MIN,84,-8,8,1610612760,1610612750,"(203500, 201586, 203460, 201566, 203103)","(201152, 203952, 203476, 2590, 201593)",True
669,0021400673,home,1610612762,UTA,90,away,1610612738,BOS,99,9,-9,1610612762,1610612738,"(204060, 202330, 202683, 202324, 203957)","(203096, 101138, 202323, 202340, 203109)",True
670,0021400674,home,1610612746,LAC,102,away,1610612743,DEN,98,-4,4,1610612746,1610612743,"(2440, 200755, 101108, 201933, 201599)","(203994, 201163, 201951, 202702, 201167)",True
671,0021400675,home,1610612754,IND,91,away,1610612761,TOR,104,-13,13,1610612754,1610612761,"(201579, 2561, 201155, 203524, 201228)","(200768, 101161, 202349, 201942, 202685)",False
672,0021400676,home,1610612765,DET,95,away,1610612739,CLE,103,8,-8,1610612765,1610612739,"(202328, 202713, 203083, 201571, 203484)","(2544, 202681, 2747, 202389, 201567)",True
673,0021400677,home,1610612748,MIA,102,away,1610612749,MIL,109,-7,7,1610612748,1610612749,"(201596, 101122, 2547, 2548, 202355)","(202688, 2585, 203114, 203507, 101141)",False
674,0021400678,home,1610612742,DAL,90,away,1610612763,MEM,109,-19,19,1610612742,1610612763,"(202718, 101145, 1717, 200765, 2199)","(2216, 201145, 201584, 201188, 2757)",False
675,0021400679,home,1610612744,GSW,111,away,1610612741,CHI,113,2,-2,1610612744,1610612741,"(201939, 201578, 202691, 203084, 203110)","(2200, 201565, 201149, 2550, 203503)",True
676,0021400680,home,1610612747,LAL,92,away,1610612764,WAS,98,-6,6,1610612747,1610612764,"(201961, 203903, 201941, 203135, 203527)","(203490, 2403, 202322, 101162, 203078)",False
677,0021400681,home,1610612739,CLE,99,away,1610612757,POR,94,5,-5,1610612739,1610612757,"(202681, 1890, 2747, 202389, 201567)","(203081, 200746, 202083, 201587, 2549)",False
678,0021400682,home,1610612755,PHI,89,away,1610612765,DET,69,-20,20,1610612755,1610612765,"(203496, 201601, 203960, 203487, 203457)","(202328, 202713, 203083, 201571, 203484)",True
679,0021400683,home,1610612737,ATL,113,away,1610612751,BKN,102,11,-11,1610612737,1610612751,"(201952, 201960, 2594, 200794, 201143)","(101187, 708, 2207, 203486, 101127)",False
680,0021400684,home,1610612761,TOR,119,away,1610612758,SAC,102,-17,17,1610612761,1610612758,"(200768, 101161, 202349, 201942, 202685)","(200752, 201954, 202326, 201574, 203463)",True
681,0021400685,home,1610612745,HOU,99,away,1610612742,DAL,94,-5,5,1610612745,1610612742,"(201976, 2772, 201595, 202700, 201935)","(202718, 101145, 1717, 200765, 2199)",True
682,0021400686,home,1610612750,MIN,110,away,1610612738,BOS,98,-12,12,1610612750,1610612738,"(201152, 203952, 203476, 201593, 203897)","(203096, 101138, 202323, 202340, 203109)",True
683,0021400687,home,1610612740,NOP,85,away,1610612743,DEN,93,8,-8,1610612740,1610612743,"(201600, 201569, 201936, 203076, 201967)","(203994, 201163, 201951, 202702, 201167)",True
684,0021400688,home,1610612752,NYK,100,away,1610612760,OKC,92,8,-8,1610612752,1610612760,"(201160, 2546, 200811, 101181, 204038)","(203500, 201586, 203460, 201566, 203103)",False
685,0021400689,home,1610612759,SAS,95,away,1610612766,CHA,86,-9,9,1610612759,1610612766,"(2225, 1495, 201980, 2588, 202695)","(2744, 201945, 203148, 203077, 203469)",True
686,0021400690,home,1610612762,UTA,89,away,1610612746,LAC,94,5,-5,1610612762,1610612746,"(204060, 202330, 202683, 202324, 203957)","(2440, 2037, 101108, 201933, 201599)",True
687,0021400691,home,1610612756,PHX,106,away,1610612764,WAS,98,8,-8,1610612756,1610612764,"(201609, 203458, 202339, 202693, 200782)","(101162, 2743, 202322, 203078, 1718)",False
688,0021400692,home,1610612753,ORL,100,away,1610612749,MIL,115,15,-15,1610612753,1610612749,"(202696, 101112, 203506, 203932, 203901)","(202688, 203089, 201162, 203507, 203114)",True
689,0021400693,home,1610612763,MEM,99,away,1610612743,DEN,69,-30,30,1610612763,1610612743,"(2216, 201584, 201188, 2757, 201145)","(203994, 201163, 201951, 202702, 201167)",True
690,0021400694,home,1610612754,IND,103,away,1610612752,NYK,82,21,-21,1610612754,1610612752,"(2561, 201579, 203524, 201228, 201155)","(201160, 2546, 200811, 101181, 204038)",False
691,0021400695,home,1610612747,LAL,123,away,1610612741,CHI,118,-5,5,1610612747,1610612741,"(201961, 203903, 203135, 201941, 203527)","(2200, 201565, 201149, 202710, 202703)",True
692,0021400696,home,1610612755,PHI,103,away,1610612750,MIN,94,-9,9,1610612755,1610612750,"(203496, 201601, 203960, 203487, 203457)","(201152, 203952, 203897, 203476, 201593)",True
693,0021400697,home,1610612737,ATL,105,away,1610612757,POR,99,6,-6,1610612737,1610612757,"(201952, 2594, 200794, 200757, 201143)","(203081, 200746, 202083, 201587, 2549)",False
694,0021400698,home,1610612738,BOS,87,away,1610612745,HOU,93,-6,6,1610612738,1610612745,"(203096, 101138, 202323, 202340, 203109)","(201976, 2772, 201595, 202700, 201935)",False
695,0021400699,home,1610612751,BKN,122,away,1610612761,TOR,127,-5,5,1610612751,1610612761,"(101187, 708, 2207, 203486, 101127)","(200768, 101161, 202349, 201942, 202685)",False
696,0021400700,home,1610612739,CLE,101,away,1610612758,SAC,90,11,-11,1610612739,1610612758,"(2544, 202681, 2747, 202389, 201567)","(200752, 201954, 202326, 201574, 203463)",False
697,0021400701,home,1610612740,NOP,108,away,1610612746,LAC,103,-5,5,1610612740,1610612746,"(201600, 201569, 201583, 201936, 201967)","(2440, 200755, 101108, 201933, 201599)",True
698,0021400702,home,1610612748,MIA,72,away,1610612742,DAL,93,21,-21,1610612748,1610612742,"(101122, 202355, 201596, 203894, 2547)","(101145, 2210, 1717, 200765, 2199)",True
699,0021400703,home,1610612762,UTA,110,away,1610612744,GSW,100,-10,10,1610612762,1610612744,"(204060, 202330, 202683, 202324, 203957)","(201939, 101106, 202691, 203084, 203110)",True
700,0021400704,home,1610612756,PHX,99,away,1610612741,CHI,93,-6,6,1610612756,1610612741,"(201609, 203458, 202339, 202693, 200782)","(2200, 201565, 201149, 202710, 203503)",True
701,0021400705,home,1610612754,IND,94,away,1610612758,SAC,99,-5,5,1610612754,1610612758,"(201579, 2561, 201155, 203524, 201228)","(200752, 201954, 202326, 201574, 203463)",False
702,0021400706,home,1610612753,ORL,93,away,1610612742,DAL,108,15,-15,1610612753,1610612742,"(202696, 202699, 203932, 203901, 203095)","(101145, 2210, 1717, 200765, 2199)",True
703,0021400707,home,1610612764,WAS,116,away,1610612761,TOR,120,4,-4,1610612764,1610612761,"(101162, 2403, 202322, 203078, 1718)","(200768, 101161, 202349, 201942, 202685)",True
704,0021400708,home,1610612737,ATL,91,away,1610612755,PHI,85,6,-6,1610612737,1610612755,"(201952, 203145, 2594, 200794, 201143)","(203496, 201601, 203960, 203487, 203457)",False
705,0021400709,home,1610612765,DET,114,away,1610612745,HOU,101,13,-13,1610612765,1610612745,"(202328, 202713, 203083, 201571, 203484)","(201976, 2772, 201595, 202700, 201935)",False
706,0021400710,home,1610612763,MEM,85,away,1610612760,OKC,74,11,-11,1610612763,1610612760,"(2216, 201584, 201144, 201188, 201145)","(203500, 201586, 203460, 201566, 201142)",False
707,0021400711,home,1610612750,MIN,90,away,1610612739,CLE,106,16,-16,1610612750,1610612739,"(201152, 203952, 2755, 203485, 201593)","(2544, 202681, 2747, 202389, 201567)",True
708,0021400712,home,1610612749,MIL,95,away,1610612757,POR,88,7,-7,1610612749,1610612757,"(202688, 203089, 201162, 203507, 203114)","(203081, 200746, 202083, 201587, 203086)",False
709,0021400713,home,1610612743,DEN,86,away,1610612766,CHA,104,18,-18,1610612743,1610612766,"(201568, 203994, 201163, 201951, 201167)","(2744, 201945, 203148, 203077, 203469)",True
710,0021400714,home,1610612759,SAS,85,away,1610612746,LAC,105,20,-20,1610612759,1610612746,"(201168, 2225, 1495, 201980, 202695)","(2440, 200755, 101108, 201933, 201599)",True
711,0021400715,home,1610612744,GSW,106,away,1610612756,PHX,87,19,-19,1610612744,1610612756,"(202691, 101106, 201939, 203084, 203110)","(201609, 203458, 202339, 202693, 200782)",False
712,0021400716,home,1610612738,BOS,75,away,1610612748,MIA,83,-8,8,1610612738,1610612748,"(203092, 101138, 202323, 202340, 203109)","(101122, 202355, 201596, 203894, 2547)",False
713,0021400717,home,1610612752,NYK,92,away,1610612747,LAL,80,-12,12,1610612752,1610612747,"(201160, 2546, 200811, 101181, 204038)","(201961, 203903, 201941, 203135, 203527)",True
714,0021400718,home,1610612739,CLE,97,away,1610612755,PHI,84,13,-13,1610612739,1610612755,"(2544, 202681, 2747, 202389, 201567)","(203496, 201601, 203960, 203487, 203457)",False
715,0021400719,home,1610612764,WAS,88,away,1610612766,CHA,92,4,-4,1610612764,1610612766,"(101162, 2403, 202322, 203078, 1718)","(2744, 201945, 203148, 203077, 203469)",True
716,0021400720,home,1610612751,BKN,102,away,1610612746,LAC,100,2,-2,1610612751,1610612746,"(101187, 708, 2207, 203486, 101127)","(2440, 200755, 101108, 201933, 201599)",False
717,0021400721,home,1610612761,TOR,75,away,1610612749,MIL,82,7,-7,1610612761,1610612749,"(200768, 101161, 202349, 201942, 202685)","(203089, 201162, 203507, 203268, 203114)",True
718,0021400722,home,1610612740,NOP,115,away,1610612737,ATL,100,-15,15,1610612740,1610612737,"(201600, 201569, 201936, 203076, 201967)","(201952, 203145, 2594, 200794, 201143)",True
719,0021400723,home,1610612760,OKC,104,away,1610612753,ORL,97,7,-7,1610612760,1610612753,"(203500, 201586, 203460, 201566, 203079)","(202696, 203506, 202699, 203932, 203901)",False
720,0021400724,home,1610612742,DAL,100,away,1610612750,MIN,94,6,-6,1610612742,1610612750,"(101145, 200826, 1717, 202718, 2199)","(201152, 201593, 201937, 2755, 203952)",False
721,0021400725,home,1610612756,PHX,101,away,1610612763,MEM,102,1,-1,1610612756,1610612763,"(201609, 203458, 202339, 202693, 200782)","(2216, 201584, 201144, 201188, 201145)",True
722,0021400726,home,1610612755,PHI,105,away,1610612743,DEN,98,-7,7,1610612755,1610612743,"(203496, 201601, 203960, 203487, 203457)","(203994, 201163, 201951, 202702, 201167)",True
723,0021400727,home,1610612765,DET,108,away,1610612748,MIA,91,17,-17,1610612765,1610612748,"(202328, 202713, 203083, 201571, 203484)","(2736, 202355, 201596, 203894, 2547)",False
724,0021400728,home,1610612752,NYK,97,away,1610612738,BOS,108,11,-11,1610612752,1610612738,"(201160, 2546, 200811, 101181, 204038)","(203096, 101138, 202323, 202340, 203935)",True
725,0021400729,home,1610612757,POR,103,away,1610612762,UTA,102,1,-1,1610612757,1610612762,"(203081, 200746, 202083, 201587, 201577)","(204060, 202330, 202683, 202324, 203957)",False
726,0021400730,home,1610612758,SAC,96,away,1610612744,GSW,121,25,-25,1610612758,1610612744,"(200752, 201954, 202682, 202326, 203463)","(201939, 101106, 202691, 203084, 203110)",True
727,0021400731,home,1610612754,IND,114,away,1610612765,DET,109,-5,5,1610612754,1610612765,"(101139, 2561, 201588, 201155, 201579)","(202328, 202713, 203083, 201571, 203484)",True
728,0021400732,home,1610612737,ATL,105,away,1610612764,WAS,96,9,-9,1610612737,1610612764,"(201952, 201960, 2594, 200794, 201143)","(101162, 2403, 202322, 203078, 1718)",False
729,0021400733,home,1610612738,BOS,104,away,1610612743,DEN,100,4,-4,1610612738,1610612743,"(203092, 101138, 202323, 202340, 203935)","(203994, 201163, 201951, 202702, 201167)",False
730,0021400734,home,1610612761,TOR,93,away,1610612751,BKN,109,16,-16,1610612761,1610612751,"(200768, 101161, 202349, 201942, 202685)","(101187, 708, 2207, 203486, 101127)",True
731,0021400735,home,1610612745,HOU,101,away,1610612741,CHI,90,-11,11,1610612745,1610612741,"(201976, 2772, 201595, 202700, 201935)","(202710, 2200, 201565, 2550, 201149)",True
732,0021400736,home,1610612749,MIL,113,away,1610612747,LAL,105,-8,8,1610612749,1610612747,"(202688, 203089, 201162, 203507, 203114)","(201961, 203903, 204028, 203135, 203527)",True
733,0021400737,home,1610612750,MIN,102,away,1610612748,MIA,101,-1,1,1610612750,1610612748,"(201152, 203952, 2755, 201593, 201937)","(2736, 202355, 201596, 203894, 2547)",True
734,0021400738,home,1610612740,NOP,91,away,1610612760,OKC,102,-11,11,1610612740,1610612760,"(201600, 201569, 203076, 201936, 201967)","(203500, 201586, 203460, 201566, 203079)",False
735,0021400739,home,1610612759,SAS,110,away,1610612753,ORL,103,-7,7,1610612759,1610612753,"(2225, 202695, 2564, 201980, 1495)","(202696, 203506, 202699, 203901, 203095)",True
736,0021400740,home,1610612762,UTA,90,away,1610612763,MEM,100,10,-10,1610612762,1610612763,"(204060, 202330, 202683, 202324, 203957)","(2216, 201584, 201144, 201188, 201145)",True
737,0021400741,home,1610612744,GSW,128,away,1610612742,DAL,114,-14,14,1610612744,1610612742,"(201939, 101106, 202691, 203084, 203110)","(101145, 200826, 1717, 202718, 2199)",True
738,0021400742,home,1610612766,CHA,94,away,1610612764,WAS,87,7,-7,1610612766,1610612764,"(2744, 201945, 203148, 203077, 203469)","(101162, 2403, 202322, 203078, 1718)",False
739,0021400743,home,1610612739,CLE,105,away,1610612746,LAC,94,11,-11,1610612739,1610612746,"(2544, 202681, 2747, 202389, 201567)","(2440, 2037, 101108, 201933, 201599)",False
740,0021400744,home,1610612758,SAC,78,away,1610612742,DAL,101,23,-23,1610612758,1610612742,"(200752, 201954, 202326, 201574, 203463)","(202329, 200826, 101145, 202718, 2199)",True
741,0021400745,home,1610612757,POR,108,away,1610612756,PHX,87,-21,21,1610612757,1610612756,"(203081, 200746, 202083, 201587, 201577)","(201609, 203458, 202339, 202693, 200782)",True
742,0021400746,home,1610612751,BKN,92,away,1610612752,NYK,88,4,-4,1610612751,1610612752,"(101187, 708, 2207, 203486, 101127)","(201160, 2546, 200811, 101181, 204038)",False
743,0021400747,home,1610612754,IND,103,away,1610612739,CLE,99,-4,4,1610612754,1610612739,"(101139, 2561, 201588, 201579, 203524)","(2544, 202681, 2747, 202389, 201567)",True
744,0021400748,home,1610612753,ORL,103,away,1610612747,LAL,97,-6,6,1610612753,1610612747,"(202696, 101112, 203506, 202699, 203901)","(201961, 203903, 204028, 203135, 203527)",True
745,0021400749,home,1610612737,ATL,124,away,1610612744,GSW,116,8,-8,1610612737,1610612744,"(201952, 201960, 2594, 200794, 201143)","(201939, 101106, 202691, 203084, 203110)",False
746,0021400750,home,1610612738,BOS,107,away,1610612755,PHI,96,11,-11,1610612738,1610612755,"(203096, 101138, 202323, 202340, 203935)","(203496, 201601, 203960, 203909, 203457)",False
747,0021400751,home,1610612765,DET,98,away,1610612743,DEN,88,-10,10,1610612765,1610612743,"(202328, 202713, 203083, 201571, 203484)","(203994, 201163, 201951, 202702, 201167)",True
748,0021400752,home,1610612761,TOR,123,away,1610612746,LAC,107,-16,16,1610612761,1610612746,"(200768, 101161, 202349, 201942, 202685)","(2440, 201599, 101108, 201933, 203085)",True
749,0021400753,home,1610612745,HOU,117,away,1610612749,MIL,111,6,-6,1610612745,1610612749,"(201976, 2772, 201595, 202700, 201935)","(202688, 203089, 201162, 203507, 203114)",False
750,0021400754,home,1610612750,MIN,90,away,1610612763,MEM,89,-1,1,1610612750,1610612763,"(201152, 203952, 2755, 201593, 201937)","(2216, 201584, 201144, 201188, 201145)",True
751,0021400755,home,1610612760,OKC,113,away,1610612740,NOP,116,3,-3,1610612760,1610612740,"(203500, 201586, 203460, 201566, 201142)","(201600, 201569, 203076, 201936, 201967)",True
752,0021400756,home,1610612756,PHX,100,away,1610612762,UTA,93,7,-7,1610612756,1610612762,"(201609, 202339, 202693, 200782, 203101)","(204060, 202330, 202683, 202324, 203957)",False
753,0021400757,home,1610612759,SAS,98,away,1610612748,MIA,85,-13,13,1610612759,1610612748,"(2225, 1495, 201980, 203382, 202695)","(2736, 2547, 201596, 2365, 203894)",True
754,0021400758,home,1610612740,NOP,72,away,1610612741,CHI,107,35,-35,1610612740,1610612741,"(201600, 201569, 201936, 203076, 201967)","(202710, 2200, 201565, 2550, 201149)",True
755,0021400759,home,1610612764,WAS,114,away,1610612751,BKN,77,-37,37,1610612764,1610612751,"(203490, 2403, 202322, 101162, 1718)","(101187, 201572, 2207, 203486, 101127)",True
756,0021400760,home,1610612752,NYK,92,away,1610612744,GSW,106,14,-14,1610612752,1610612744,"(201160, 202498, 200811, 101181, 204038)","(201939, 101106, 202691, 203084, 203110)",True
757,0021400761,home,1610612755,PHI,89,away,1610612766,CHA,81,-8,8,1610612755,1610612766,"(203496, 201601, 204025, 203960, 203457)","(2744, 201945, 203148, 203077, 203469)",True
758,0021400762,home,1610612742,DAL,111,away,1610612757,POR,101,10,-10,1610612742,1610612757,"(101145, 200826, 1717, 202718, 2199)","(203081, 200746, 202083, 201587, 201577)",False
759,0021400763,home,1610612749,MIL,96,away,1610612738,BOS,93,-3,3,1610612749,1610612738,"(202688, 203089, 201162, 203507, 203114)","(203096, 101138, 202323, 202340, 203935)",True
760,0021400764,home,1610612762,UTA,102,away,1610612758,SAC,90,-12,12,1610612762,1610612758,"(202330, 202683, 202324, 203957, 202407)","(200752, 201196, 202326, 201574, 203463)",True
761,0021400765,home,1610612760,OKC,131,away,1610612746,LAC,108,-23,23,1610612760,1610612746,"(203500, 201586, 203460, 201142, 201566)","(2440, 101108, 203085, 201150, 201599)",True
762,0021400766,home,1610612739,CLE,120,away,1610612747,LAL,105,15,-15,1610612739,1610612747,"(2544, 202681, 2747, 202389, 201567)","(201961, 203903, 204028, 203135, 203527)",False
763,0021400767,home,1610612763,MEM,94,away,1610612737,ATL,88,-6,6,1610612763,1610612737,"(2216, 201584, 201144, 201188, 201145)","(201952, 201960, 2594, 200794, 201143)",True
764,0021400768,home,1610612766,CHA,102,away,1610612754,IND,103,-1,1,1610612766,1610612754,"(2744, 201945, 203106, 203148, 203469)","(101139, 2561, 201588, 201155, 201579)",False
765,0021400769,home,1610612765,DET,101,away,1610612750,MIN,112,-11,11,1610612765,1610612750,"(202328, 202713, 203083, 201571, 203484)","(201152, 203952, 2755, 2590, 201593)",False
766,0021400770,home,1610612753,ORL,97,away,1610612741,CHI,98,1,-1,1610612753,1610612741,"(202696, 101112, 203506, 202699, 203901)","(2200, 201565, 201149, 202710, 203503)",True
767,0021400771,home,1610612745,HOU,98,away,1610612757,POR,109,-11,11,1610612745,1610612757,"(201976, 2772, 201595, 202700, 201935)","(203081, 200746, 202083, 201587, 201577)",False
768,0021400772,home,1610612761,TOR,87,away,1610612759,SAS,82,-5,5,1610612761,1610612759,"(200768, 101161, 201949, 201942, 202685)","(2225, 1495, 201980, 203382, 202695)",True
769,0021400773,home,1610612758,SAC,85,away,1610612756,PHX,83,-2,2,1610612758,1610612756,"(201196, 201956, 202326, 201574, 203463)","(201609, 202738, 202693, 200782, 203101)",True
770,0021400774,home,1610612754,IND,93,away,1610612759,SAS,95,-2,2,1610612754,1610612759,"(101139, 2561, 201588, 201155, 201579)","(2225, 1495, 201980, 2588, 202695)",False
771,0021400775,home,1610612755,PHI,84,away,1610612744,GSW,89,5,-5,1610612755,1610612744,"(203496, 201601, 204025, 203960, 203457)","(201939, 101106, 202691, 203084, 203110)",True
772,0021400776,home,1610612764,WAS,96,away,1610612753,ORL,80,-16,16,1610612764,1610612753,"(101162, 2403, 202322, 202066, 1718)","(202696, 101112, 203506, 203932, 203901)",True
773,0021400777,home,1610612748,MIA,109,away,1610612752,NYK,95,14,-14,1610612748,1610612752,"(2736, 202355, 201596, 203894, 2547)","(201160, 2546, 200811, 101181, 204038)",False
774,0021400778,home,1610612749,MIL,103,away,1610612751,BKN,97,-6,6,1610612749,1610612751,"(202688, 203089, 201162, 203507, 203114)","(101187, 708, 2207, 203486, 101127)",True
775,0021400779,home,1610612750,MIN,105,away,1610612737,ATL,117,12,-12,1610612750,1610612737,"(201152, 203952, 2755, 201593, 201937)","(201952, 201960, 2594, 200794, 201143)",True
776,0021400780,home,1610612740,NOP,96,away,1610612762,UTA,100,-4,4,1610612740,1610612762,"(201600, 201569, 201936, 201582, 201967)","(202330, 202683, 202324, 203957, 202407)",False
777,0021400781,home,1610612742,DAL,98,away,1610612746,LAC,115,-17,17,1610612742,1610612746,"(101145, 200826, 1717, 202718, 2199)","(2440, 200755, 101108, 201150, 201599)",False
778,0021400782,home,1610612743,DEN,114,away,1610612760,OKC,124,-10,10,1610612743,1610612760,"(203994, 201163, 201951, 202702, 201167)","(201566, 2570, 203460, 201586, 201142)",False
779,0021400783,home,1610612766,CHA,78,away,1610612765,DET,106,-28,28,1610612766,1610612765,"(2744, 201945, 203106, 203148, 203469)","(202328, 202713, 203083, 201571, 203484)",False
780,0021400784,home,1610612756,PHX,118,away,1610612745,HOU,127,9,-9,1610612756,1610612745,"(201609, 202339, 202693, 200782, 203101)","(201976, 2772, 201595, 202700, 201935)",True
781,0021400785,home,1610612741,CHI,104,away,1610612758,SAC,86,18,-18,1610612741,1610612758,"(2200, 2399, 201565, 202710, 201149)","(200752, 201196, 201574, 202326, 203463)",False
782,0021400786,home,1610612763,MEM,95,away,1610612751,BKN,86,-9,9,1610612763,1610612751,"(2216, 201584, 201144, 201188, 201145)","(101187, 708, 2207, 203486, 101127)",True
783,0021400787,home,1610612747,LAL,96,away,1610612743,DEN,106,10,-10,1610612747,1610612743,"(201961, 203903, 203135, 204028, 203527)","(203994, 201163, 201951, 202702, 201167)",True
784,0021400788,home,1610612753,ORL,89,away,1610612752,NYK,83,-6,6,1610612753,1610612752,"(202696, 101112, 203506, 203901, 203095)","(201160, 200811, 203501, 204038, 101181)",True
785,0021400789,home,1610612738,BOS,89,away,1610612737,ATL,88,-1,1,1610612738,1610612737,"(203096, 101138, 202323, 202340, 203935)","(201952, 201960, 2594, 200794, 201143)",True
786,0021400790,home,1610612765,DET,87,away,1610612759,SAS,104,-17,17,1610612765,1610612759,"(202328, 202713, 203083, 201571, 203484)","(2225, 1495, 201980, 203382, 202695)",False
787,0021400791,home,1610612761,TOR,95,away,1610612764,WAS,93,2,-2,1610612761,1610612764,"(200768, 101161, 201949, 201942, 202685)","(203490, 2403, 202322, 101162, 1718)",False
788,0021400792,home,1610612749,MIL,111,away,1610612758,SAC,103,8,-8,1610612749,1610612758,"(202688, 203089, 201162, 203507, 203114)","(200752, 201196, 201956, 202326, 203463)",False
789,0021400793,home,1610612750,MIN,91,away,1610612744,GSW,94,3,-3,1610612750,1610612744,"(201152, 203952, 2755, 201593, 201937)","(202691, 101106, 201939, 203084, 203110)",True
790,0021400794,home,1610612740,NOP,93,away,1610612754,IND,106,13,-13,1610612740,1610612754,"(201600, 201569, 201936, 201582, 201967)","(101139, 2561, 201588, 201579, 203524)",True
791,0021400795,home,1610612760,OKC,105,away,1610612763,MEM,89,-16,16,1610612760,1610612763,"(201566, 2570, 203460, 201586, 201142)","(2216, 201584, 201144, 201188, 201145)",True
792,0021400796,home,1610612739,CLE,113,away,1610612748,MIA,93,20,-20,1610612739,1610612748,"(2544, 202681, 2747, 202389, 201567)","(2736, 202355, 201596, 203894, 2547)",False
793,0021400797,home,1610612742,DAL,87,away,1610612762,UTA,82,5,-5,1610612742,1610612762,"(101145, 202962, 200826, 202718, 1717)","(202330, 202683, 202324, 203957, 202407)",False
794,0021400798,home,1610612757,POR,102,away,1610612747,LAL,86,-16,16,1610612757,1610612747,"(203081, 200746, 202083, 201587, 201577)","(201961, 203903, 204028, 203135, 203527)",True
795,0021400799,home,1610612746,LAC,110,away,1610612745,HOU,95,-15,15,1610612746,1610612745,"(2440, 200755, 101108, 201150, 201599)","(201976, 2772, 201595, 202700, 201935)",True
796,0021400800,home,1610612741,CHI,113,away,1610612739,CLE,98,15,-15,1610612741,1610612739,"(2200, 2399, 201149, 201565, 203503)","(2544, 202681, 2747, 202684, 202389)",False
797,0021400801,home,1610612760,OKC,104,away,1610612742,DAL,89,-15,15,1610612760,1610612742,"(201586, 2555, 203460, 201142, 201566)","(101145, 1717, 200765, 202718, 2199)",True
798,0021400802,home,1610612746,LAC,119,away,1610612759,SAS,115,4,-4,1610612746,1610612759,"(2440, 200755, 101108, 201150, 201599)","(2225, 1495, 201980, 203382, 202695)",False
799,0021400803,home,1610612753,ORL,95,away,1610612740,NOP,84,-11,11,1610612753,1610612740,"(202696, 101112, 203506, 203901, 203095)","(201600, 201569, 201936, 203076, 201967)",True
800,0021400804,home,1610612755,PHI,95,away,1610612754,IND,106,11,-11,1610612755,1610612754,"(203496, 201601, 2202, 204025, 203457)","(101139, 201588, 201579, 203524, 2561)",True
801,0021400805,home,1610612737,ATL,80,away,1610612761,TOR,105,-25,25,1610612737,1610612761,"(201952, 201960, 2594, 200794, 201143)","(200768, 101161, 201949, 201942, 202685)",False
802,0021400806,home,1610612765,DET,100,away,1610612741,CHI,91,-9,9,1610612765,1610612741,"(202328, 203083, 203915, 203484, 2406)","(2200, 2399, 201565, 202710, 201149)",True
803,0021400807,home,1610612752,NYK,87,away,1610612748,MIA,111,24,-24,1610612752,1610612748,"(201160, 203921, 200811, 101181, 204038)","(2736, 2617, 201596, 202355, 2548)",True
804,0021400808,home,1610612750,MIN,111,away,1610612756,PHX,109,2,-2,1610612750,1610612756,"(203952, 201937, 2755, 203461, 201593)","(202339, 203458, 101123, 202693, 200782)",False
805,0021400809,home,1610612764,WAS,89,away,1610612739,CLE,127,38,-38,1610612764,1610612739,"(203490, 2403, 202322, 101162, 1718)","(2544, 202681, 2747, 202389, 201567)",True
806,0021400810,home,1610612742,DAL,111,away,1610612745,HOU,100,11,-11,1610612742,1610612745,"(202718, 101145, 1717, 200765, 2199)","(201976, 2772, 201595, 202700, 201935)",False
807,0021400811,home,1610612749,MIL,89,away,1610612743,DEN,81,-8,8,1610612749,1610612743,"(203114, 203089, 201162, 203507, 201573)","(201568, 203994, 201163, 2749, 202702)",True
808,0021400812,home,1610612762,UTA,92,away,1610612757,POR,76,-16,16,1610612762,1610612757,"(203497, 202330, 202324, 203957, 204060)","(201577, 200746, 202083, 201587, 203081)",True
809,0021400813,home,1610612758,SAC,109,away,1610612738,BOS,101,-8,8,1610612758,1610612738,"(200752, 201171, 203492, 202326, 203463)","(202340, 101138, 202323, 203092, 203935)",True
810,0021400814,home,1610612744,GSW,110,away,1610612759,SAS,99,11,-11,1610612744,1610612759,"(201939, 101106, 202691, 203084, 203110)","(2225, 1495, 201980, 203382, 202695)",False
811,0021400815,home,1610612747,LAL,105,away,1610612751,BKN,114,9,-9,1610612747,1610612751,"(201961, 203903, 203135, 204028, 203527)","(101114, 101187, 2207, 203486, 202711)",True
812,0021400816,home,1610612766,CHA,103,away,1610612760,OKC,110,-7,7,1610612766,1610612760,"(2744, 201945, 203077, 2590, 203469)","(202713, 201586, 202683, 203460, 201566)",False
813,0021400817,home,1610612748,MIA,91,away,1610612740,NOP,105,-14,14,1610612748,1610612740,"(2736, 201609, 202355, 2548, 2617)","(201600, 201569, 201936, 202347, 203076)",False
814,0021400818,home,1610612741,CHI,112,away,1610612756,PHX,107,5,-5,1610612741,1610612756,"(2200, 2399, 201565, 202710, 201149)","(202339, 203458, 101123, 202693, 200782)",False
815,0021400819,home,1610612745,HOU,98,away,1610612761,TOR,76,22,-22,1610612745,1610612761,"(201976, 2772, 201595, 202700, 201935)","(200768, 101161, 201949, 201942, 202685)",False
816,0021400820,home,1610612746,LAC,126,away,1610612758,SAC,99,27,-27,1610612746,1610612758,"(2440, 200755, 101108, 201150, 201599)","(200752, 203492, 202326, 201574, 203463)",False
817,0021400821,home,1610612752,NYK,83,away,1610612739,CLE,101,18,-18,1610612752,1610612739,"(201160, 202498, 200811, 101181, 204038)","(2544, 202681, 2747, 202389, 201567)",True
818,0021400822,home,1610612749,MIL,86,away,1610612737,ATL,97,11,-11,1610612749,1610612737,"(201162, 203089, 203114, 203507, 201573)","(201952, 201960, 2594, 200794, 201143)",True
819,0021400823,home,1610612765,DET,106,away,1610612764,WAS,89,17,-17,1610612765,1610612764,"(202704, 202328, 203083, 203484, 2406)","(101162, 2403, 202322, 202066, 1718)",False
820,0021400824,home,1610612754,IND,104,away,1610612744,GSW,98,-6,6,1610612754,1610612744,"(101139, 2561, 201588, 201579, 203524)","(101106, 202691, 203084, 2733, 203110)",True
821,0021400825,home,1610612753,ORL,103,away,1610612755,PHI,98,5,-5,1610612753,1610612755,"(202696, 101112, 203506, 202699, 203901)","(203496, 203457, 2202, 203156, 203477)",False
822,0021400826,home,1610612760,OKC,119,away,1610612743,DEN,94,-25,25,1610612760,1610612743,"(202713, 201586, 202683, 203460, 201566)","(201568, 203994, 201163, 202702, 201951)",True
823,0021400827,home,1610612742,DAL,92,away,1610612766,CHA,81,-11,11,1610612742,1610612766,"(101145, 2210, 1717, 200765, 2199)","(2744, 201945, 203077, 2590, 203469)",True
824,0021400828,home,1610612757,POR,92,away,1610612763,MEM,98,6,-6,1610612757,1610612763,"(203081, 202083, 201587, 203086, 201577)","(2216, 201584, 201144, 201188, 201145)",True
825,0021400829,home,1610612747,LAL,118,away,1610612738,BOS,111,-7,7,1610612747,1610612738,"(201961, 203903, 203527, 2430, 203135)","(203092, 101138, 202323, 202340, 203935)",True
826,0021400830,home,1610612748,MIA,119,away,1610612755,PHI,108,11,-11,1610612748,1610612755,"(2736, 201609, 202355, 2548, 2617)","(203496, 201601, 203156, 203477, 203457)",False
827,0021400831,home,1610612741,CHI,87,away,1610612749,MIL,71,16,-16,1610612741,1610612749,"(2200, 2399, 201565, 202710, 201149)","(203089, 203114, 203507, 201573, 101141)",False
828,0021400832,home,1610612745,HOU,113,away,1610612750,MIN,102,11,-11,1610612745,1610612750,"(2772, 1891, 202700, 203093, 201935)","(203952, 201937, 2755, 203940, 201593)",False
829,0021400833,home,1610612740,NOP,100,away,1610612761,TOR,97,3,-3,1610612740,1610612761,"(201600, 201569, 202347, 201936, 201967)","(200768, 101161, 201949, 201942, 202685)",False
830,0021400834,home,1610612743,DEN,82,away,1610612751,BKN,110,28,-28,1610612743,1610612751,"(201568, 203914, 201951, 201589, 203994)","(101114, 101187, 203900, 203486, 2207)",True
831,0021400835,home,1610612756,PHX,110,away,1610612738,BOS,115,5,-5,1610612756,1610612738,"(202688, 203458, 202339, 202693, 200782)","(203092, 101138, 202323, 202340, 203935)",True
832,0021400836,home,1610612762,UTA,90,away,1610612759,SAS,81,-9,9,1610612762,1610612759,"(202324, 203497, 202330, 204060, 203957)","(2225, 1495, 201980, 203382, 202695)",True
833,0021400837,home,1610612746,LAC,87,away,1610612763,MEM,90,-3,3,1610612746,1610612763,"(2440, 200755, 101108, 201150, 201599)","(2216, 201584, 201144, 201188, 201145)",False
834,0021400838,home,1610612764,WAS,107,away,1610612744,GSW,114,7,-7,1610612764,1610612744,"(101162, 2403, 202322, 202066, 1718)","(202691, 101106, 201939, 203084, 203110)",True
835,0021400839,home,1610612765,DET,93,away,1610612739,CLE,102,9,-9,1610612765,1610612739,"(202704, 202328, 2419, 203083, 203484)","(2544, 202681, 2747, 202389, 201567)",True
836,0021400840,home,1610612760,OKC,105,away,1610612754,IND,92,-13,13,1610612760,1610612754,"(202713, 201586, 202683, 203460, 201566)","(101139, 2561, 201579, 201588, 203524)",True
837,0021400841,home,1610612742,DAL,99,away,1610612761,TOR,92,7,-7,1610612742,1610612761,"(101145, 2210, 1717, 200765, 2199)","(200768, 101161, 201949, 201942, 202685)",False
838,0021400842,home,1610612753,ORL,90,away,1610612748,MIA,93,3,-3,1610612753,1610612748,"(202696, 101112, 203506, 202699, 203901)","(2736, 201609, 202355, 2548, 2617)",True
839,0021400843,home,1610612737,ATL,104,away,1610612742,DAL,87,17,-17,1610612737,1610612742,"(201952, 201960, 2594, 200794, 201143)","(101145, 2210, 203108, 1717, 200826)",False
840,0021400844,home,1610612738,BOS,115,away,1610612752,NYK,94,21,-21,1610612738,1610612752,"(203092, 101138, 202323, 202340, 203935)","(201160, 200811, 203501, 204038, 101181)",False
841,0021400845,home,1610612741,CHI,86,away,1610612766,CHA,98,12,-12,1610612741,1610612766,"(2200, 2399, 202710, 201166, 201149)","(2744, 201945, 203077, 2590, 203469)",True
842,0021400846,home,1610612745,HOU,110,away,1610612746,LAC,105,5,-5,1610612745,1610612746,"(2772, 1891, 202700, 203093, 201935)","(2440, 200755, 101108, 201150, 201599)",False
843,0021400847,home,1610612749,MIL,104,away,1610612755,PHI,88,16,-16,1610612749,1610612755,"(2585, 203114, 203507, 101141, 203487)","(203496, 201601, 2202, 203477, 203457)",False
844,0021400848,home,1610612750,MIN,97,away,1610612764,WAS,77,20,-20,1610612750,1610612764,"(203952, 201937, 2755, 708, 201593)","(202066, 203490, 2403, 202322, 101162)",False
845,0021400849,home,1610612740,NOP,102,away,1610612751,BKN,96,-6,6,1610612740,1610612751,"(201600, 201569, 202347, 201936, 201967)","(101114, 101187, 203900, 203486, 2207)",True
846,0021400850,home,1610612743,DEN,96,away,1610612756,PHX,110,-14,14,1610612743,1610612756,"(201568, 203914, 201951, 201589, 203994)","(202688, 203458, 202339, 202693, 200782)",False
847,0021400851,home,1610612762,UTA,97,away,1610612747,LAL,100,3,-3,1610612762,1610612747,"(203497, 202330, 202324, 203957, 204060)","(201961, 203903, 203135, 2430, 203527)",True
848,0021400852,home,1610612758,SAC,102,away,1610612763,MEM,90,-12,12,1610612758,1610612763,"(200752, 203492, 202326, 201574, 203463)","(2216, 201584, 201144, 201188, 201145)",True
849,0021400853,home,1610612757,POR,111,away,1610612759,SAS,95,16,-16,1610612757,1610612759,"(203081, 200746, 202083, 201587, 201577)","(2225, 1495, 201980, 203382, 202695)",False
850,0021400854,home,1610612739,CLE,110,away,1610612744,GSW,99,11,-11,1610612739,1610612744,"(2544, 202681, 2747, 202389, 201567)","(201939, 101106, 202691, 203084, 203110)",False
851,0021400855,home,1610612756,PHX,117,away,1610612760,OKC,113,-4,4,1610612756,1610612760,"(202688, 203458, 202339, 202693, 200782)","(202713, 201586, 202683, 203460, 201566)",True
852,0021400856,home,1610612754,IND,93,away,1610612739,CLE,86,-7,7,1610612754,1610612739,"(101139, 2561, 201588, 201579, 203524)","(2592, 203521, 2747, 202389, 201567)",True
853,0021400857,home,1610612755,PHI,89,away,1610612764,WAS,81,8,-8,1610612755,1610612764,"(203496, 201601, 2202, 203477, 203457)","(202066, 203490, 2403, 202322, 101162)",False
854,0021400858,home,1610612737,ATL,95,away,1610612753,ORL,88,7,-7,1610612737,1610612753,"(201952, 201960, 2594, 200794, 201143)","(202696, 101112, 203506, 202699, 203901)",False
855,0021400859,home,1610612738,BOS,106,away,1610612766,CHA,98,8,-8,1610612738,1610612766,"(203092, 101138, 202323, 202340, 203935)","(2744, 201945, 203077, 2590, 203469)",False
856,0021400860,home,1610612765,DET,115,away,1610612752,NYK,121,-6,6,1610612765,1610612752,"(202704, 202328, 2419, 203083, 203484)","(200745, 200811, 203501, 204038, 203921)",False
857,0021400861,home,1610612761,TOR,89,away,1610612744,GSW,113,24,-24,1610612761,1610612744,"(200768, 202335, 202685, 201942, 201949)","(201939, 101106, 202691, 203084, 203110)",True
858,0021400862,home,1610612741,CHI,96,away,1610612750,MIN,89,7,-7,1610612741,1610612750,"(201149, 2399, 202710, 201166, 201959)","(203952, 201937, 2755, 203940, 201593)",False
859,0021400863,home,1610612745,HOU,102,away,1610612751,BKN,98,-4,4,1610612745,1610612751,"(201976, 2772, 202700, 203093, 201935)","(101114, 101187, 203900, 203486, 2207)",True
860,0021400864,home,1610612763,MEM,79,away,1610612746,LAC,97,18,-18,1610612763,1610612746,"(2216, 201584, 201144, 201188, 201145)","(2440, 200755, 101108, 201150, 201599)",True
861,0021400865,home,1610612740,NOP,104,away,1610612748,MIA,102,-2,2,1610612740,1610612748,"(201600, 201569, 202347, 201936, 201967)","(2736, 201609, 202355, 2548, 2617)",True
862,0021400866,home,1610612743,DEN,82,away,1610612762,UTA,104,-22,22,1610612743,1610612762,"(201568, 203530, 201581, 203914, 201951)","(203497, 202330, 202324, 203957, 204060)",False
863,0021400867,home,1610612758,SAC,96,away,1610612759,SAS,107,-11,11,1610612758,1610612759,"(200752, 201171, 203492, 201574, 203463)","(201168, 2225, 1495, 201980, 202695)",False
864,0021400868,home,1610612747,LAL,101,away,1610612749,MIL,93,8,-8,1610612747,1610612749,"(201961, 203903, 203135, 2430, 203527)","(2585, 203114, 203507, 101141, 203487)",False
865,0021400869,home,1610612757,POR,115,away,1610612760,OKC,112,-3,3,1610612757,1610612760,"(203081, 200746, 202083, 201587, 201577)","(202713, 201586, 2555, 203460, 201566)",True
866,0021400870,home,1610612764,WAS,99,away,1610612765,DET,95,-4,4,1610612764,1610612765,"(101162, 2403, 202322, 203078, 1718)","(202704, 202328, 2419, 203083, 203484)",True
867,0021400871,home,1610612748,MIA,91,away,1610612737,ATL,93,2,-2,1610612748,1610612737,"(2736, 201609, 201611, 2548, 202355)","(203145, 2594, 1882, 200794, 203471)",True
868,0021400872,home,1610612752,NYK,103,away,1610612761,TOR,98,5,-5,1610612752,1610612761,"(203921, 200811, 203501, 204038, 200745)","(101161, 202685, 202349, 201942, 201949)",False
869,0021400873,home,1610612750,MIN,97,away,1610612763,MEM,101,4,-4,1610612750,1610612763,"(203952, 201593, 2755, 708, 201937)","(2216, 201584, 201144, 201188, 201145)",True
870,0021400874,home,1610612742,DAL,94,away,1610612751,BKN,104,10,-10,1610612742,1610612751,"(101145, 2210, 200765, 200826, 1717)","(101114, 101187, 203900, 203486, 2207)",True
871,0021400875,home,1610612756,PHX,74,away,1610612759,SAS,101,-27,27,1610612756,1610612759,"(202688, 203458, 202339, 202693, 200782)","(201168, 2225, 1495, 201980, 202695)",False
872,0021400876,home,1610612762,UTA,82,away,1610612749,MIL,75,-7,7,1610612762,1610612749,"(203497, 202330, 202324, 203957, 204060)","(2585, 203114, 203507, 101141, 203487)",True
873,0021400877,home,1610612741,CHI,86,away,1610612746,LAC,96,-10,10,1610612741,1610612746,"(2200, 2399, 202710, 201166, 201149)","(2440, 200755, 101108, 201150, 201599)",False
874,0021400878,home,1610612747,LAL,101,away,1610612760,OKC,108,-7,7,1610612747,1610612760,"(201961, 203903, 203135, 2430, 203527)","(202713, 201586, 201571, 203460, 202683)",False
875,0021400879,home,1610612758,SAC,99,away,1610612757,POR,110,11,-11,1610612758,1610612757,"(200752, 201171, 203492, 201574, 203463)","(203081, 200746, 202083, 201587, 201577)",True
876,0021400880,home,1610612738,BOS,101,away,1610612744,GSW,106,-5,5,1610612738,1610612744,"(203092, 101138, 202323, 202340, 203935)","(201939, 101106, 202691, 203084, 203110)",False
877,0021400881,home,1610612754,IND,94,away,1610612755,PHI,74,20,-20,1610612754,1610612755,"(2561, 201588, 201579, 203524, 204014)","(203496, 201601, 2202, 203477, 203457)",False
878,0021400882,home,1610612753,ORL,83,away,1610612766,CHA,98,15,-15,1610612753,1610612766,"(202696, 101112, 203506, 202699, 203901)","(2744, 201945, 203077, 2590, 203469)",True
879,0021400883,home,1610612745,HOU,105,away,1610612739,CLE,103,-2,2,1610612745,1610612739,"(201976, 2772, 202700, 203093, 201935)","(2544, 203521, 2747, 202389, 201567)",True
880,0021400884,home,1610612743,DEN,92,away,1610612740,NOP,99,-7,7,1610612743,1610612740,"(201568, 201163, 201951, 202702, 200751)","(201600, 201569, 202347, 201936, 201967)",False
881,0021400885,home,1610612755,PHI,103,away,1610612761,TOR,114,-11,11,1610612755,1610612761,"(203960, 201601, 203156, 203477, 203457)","(101161, 202685, 202349, 201942, 201949)",False
882,0021400886,home,1610612751,BKN,110,away,1610612744,GSW,108,2,-2,1610612751,1610612744,"(101114, 101187, 203900, 203486, 2207)","(101106, 202691, 203084, 203110, 201939)",False
883,0021400887,home,1610612748,MIA,115,away,1610612756,PHX,98,17,-17,1610612748,1610612756,"(2736, 201609, 202355, 2548, 2617)","(202688, 203458, 202339, 202693, 200782)",False
884,0021400888,home,1610612750,MIN,105,away,1610612746,LAC,110,5,-5,1610612750,1610612746,"(203952, 201937, 203476, 708, 202390)","(202706, 200755, 101108, 201150, 201599)",True
885,0021400889,home,1610612742,DAL,102,away,1610612740,NOP,93,9,-9,1610612742,1610612740,"(101145, 2210, 203108, 1717, 200765)","(201600, 201569, 202347, 201936, 201967)",False
886,0021400890,home,1610612766,CHA,104,away,1610612747,LAL,103,1,-1,1610612766,1610612747,"(2744, 201945, 203077, 2590, 203469)","(201961, 203903, 203135, 2430, 203527)",False
887,0021400891,home,1610612739,CLE,110,away,1610612738,BOS,79,-31,31,1610612739,1610612738,"(2544, 202681, 2747, 202389, 201567)","(203092, 101138, 202323, 202340, 203935)",True
888,0021400892,home,1610612737,ATL,104,away,1610612745,HOU,96,8,-8,1610612737,1610612745,"(201952, 201960, 2594, 200794, 201143)","(201976, 2772, 201147, 202700, 203093)",False
889,0021400893,home,1610612741,CHI,97,away,1610612764,WAS,92,5,-5,1610612741,1610612764,"(2200, 2399, 201149, 201166, 203503)","(101162, 2403, 202322, 203078, 1718)",False
890,0021400894,home,1610612763,MEM,82,away,1610612762,UTA,93,-11,11,1610612763,1610612762,"(201584, 201585, 201144, 201188, 201145)","(203497, 202330, 202324, 203957, 204060)",False
891,0021400895,home,1610612743,DEN,106,away,1610612749,MIL,95,11,-11,1610612743,1610612749,"(201568, 201163, 201951, 202702, 200751)","(2585, 203114, 203507, 101141, 203487)",False
892,0021400896,home,1610612754,IND,105,away,1610612752,NYK,82,23,-23,1610612754,1610612752,"(2561, 201588, 101139, 203524, 101133)","(200745, 200811, 203501, 204038, 203921)",False
893,0021400897,home,1610612753,ORL,100,away,1610612756,PHX,105,-5,5,1610612753,1610612756,"(202696, 203473, 203506, 202699, 203901)","(202688, 203458, 202339, 202693, 200782)",False
894,0021400898,home,1610612738,BOS,85,away,1610612762,UTA,84,1,-1,1610612738,1610612762,"(203092, 101138, 202323, 202340, 203935)","(203497, 202330, 202324, 203957, 204060)",False
895,0021400899,home,1610612751,BKN,91,away,1610612766,CHA,115,-24,24,1610612751,1610612766,"(101114, 101187, 203900, 203486, 2207)","(2744, 201945, 101107, 203077, 2590)",False
896,0021400900,home,1610612761,TOR,112,away,1610612739,CLE,120,8,-8,1610612761,1610612739,"(101161, 202685, 202349, 201942, 201949)","(2544, 202681, 2747, 202389, 201567)",True
897,0021400901,home,1610612745,HOU,100,away,1610612763,MEM,102,-2,2,1610612745,1610612763,"(201976, 2772, 202700, 203093, 201935)","(2216, 201584, 201144, 201188, 201145)",False
898,0021400902,home,1610612750,MIN,85,away,1610612743,DEN,100,15,-15,1610612750,1610612743,"(203952, 201937, 2755, 708, 201593)","(201568, 201163, 201951, 202702, 200751)",True
899,0021400903,home,1610612740,NOP,88,away,1610612765,DET,85,-3,3,1610612740,1610612765,"(201600, 201569, 201936, 202347, 203076)","(202328, 202704, 2419, 203083, 203484)",True
900,0021400904,home,1610612760,OKC,123,away,1610612755,PHI,118,5,-5,1610612760,1610612755,"(202713, 201586, 202683, 203460, 201566)","(203960, 201601, 2202, 203477, 203457)",False
901,0021400905,home,1610612748,MIA,100,away,1610612747,LAL,94,-6,6,1610612748,1610612747,"(2736, 201609, 202355, 2548, 2617)","(201961, 203903, 203135, 2430, 203527)",True
902,0021400906,home,1610612759,SAS,112,away,1610612758,SAC,85,-27,27,1610612759,1610612758,"(201168, 2225, 1495, 201980, 202695)","(200752, 203492, 202326, 201574, 203463)",True
903,0021400907,home,1610612744,GSW,102,away,1610612749,MIL,93,9,-9,1610612744,1610612749,"(201939, 101106, 202691, 203084, 203110)","(2585, 201162, 203507, 203114, 203487)",False
904,0021400908,home,1610612746,LAC,93,away,1610612757,POR,98,-5,5,1610612746,1610612757,"(202706, 200755, 101108, 201150, 201599)","(203081, 200746, 202083, 201587, 201577)",False
905,0021400909,home,1610612741,CHI,108,away,1610612760,OKC,105,3,-3,1610612741,1610612760,"(2200, 2399, 201149, 201166, 203503)","(202713, 201586, 202683, 203460, 201566)",False
906,0021400910,home,1610612757,POR,94,away,1610612742,DAL,75,-19,19,1610612757,1610612742,"(201577, 200746, 202083, 201587, 203081)","(101145, 2210, 1717, 200765, 2199)",True
907,0021400911,home,1610612766,CHA,103,away,1610612761,TOR,94,9,-9,1610612766,1610612761,"(2744, 201945, 203077, 2590, 203469)","(200768, 101161, 203082, 202685, 201942)",False
908,0021400912,home,1610612754,IND,98,away,1610612741,CHI,84,-14,14,1610612754,1610612741,"(101139, 2561, 201588, 201579, 203524)","(2200, 2399, 201149, 201166, 203503)",True
909,0021400913,home,1610612753,ORL,119,away,1610612758,SAC,114,5,-5,1610612753,1610612758,"(101112, 203473, 203506, 202699, 203901)","(200752, 203492, 202326, 201574, 203463)",False
910,0021400914,home,1610612755,PHI,83,away,1610612762,UTA,89,-6,6,1610612755,1610612762,"(203960, 201601, 2202, 203477, 203457)","(203497, 202330, 202324, 203957, 204060)",False
911,0021400915,home,1610612737,ATL,106,away,1610612739,CLE,97,9,-9,1610612737,1610612739,"(201952, 201960, 2594, 200794, 201143)","(2544, 202681, 2747, 202389, 201567)",False
912,0021400916,home,1610612751,BKN,100,away,1610612756,PHX,108,-8,8,1610612751,1610612756,"(101114, 101187, 203900, 203486, 2207)","(202688, 203458, 202339, 202693, 202694)",False
913,0021400917,home,1610612745,HOU,103,away,1610612765,DET,93,-10,10,1610612745,1610612765,"(201976, 2772, 202700, 203093, 201935)","(202704, 202328, 2419, 203083, 203484)",True
914,0021400918,home,1610612763,MEM,97,away,1610612747,LAL,90,-7,7,1610612763,1610612747,"(2216, 201584, 201144, 201188, 201145)","(201961, 203903, 203135, 2430, 203527)",True
915,0021400919,home,1610612740,NOP,98,away,1610612738,BOS,104,6,-6,1610612740,1610612738,"(201600, 201569, 201936, 202347, 203076)","(101138, 202323, 203092, 203109, 203935)",True
916,0021400920,home,1610612764,WAS,99,away,1610612748,MIA,97,-2,2,1610612764,1610612748,"(101162, 2403, 202322, 203078, 1718)","(201609, 201611, 204020, 202355, 2617)",True
917,0021400921,home,1610612759,SAS,120,away,1610612743,DEN,111,-9,9,1610612759,1610612743,"(201168, 2225, 1495, 201980, 202695)","(201568, 201163, 201951, 202702, 200751)",True
918,0021400922,home,1610612744,GSW,104,away,1610612742,DAL,89,-15,15,1610612744,1610612742,"(201939, 101106, 202691, 203084, 203110)","(101145, 2210, 1717, 200765, 2199)",True
919,0021400923,home,1610612740,NOP,95,away,1610612763,MEM,89,-6,6,1610612740,1610612763,"(201600, 201569, 201936, 202347, 203076)","(2216, 201584, 201144, 201188, 201145)",True
920,0021400924,home,1610612739,CLE,89,away,1610612756,PHX,79,10,-10,1610612739,1610612756,"(2544, 202681, 2747, 202389, 201567)","(202688, 202339, 2853, 200782, 202693)",False
921,0021400925,home,1610612748,MIA,114,away,1610612758,SAC,109,5,-5,1610612748,1610612758,"(2617, 201611, 2548, 2365, 203894)","(200752, 203492, 201574, 202326, 203463)",False
922,0021400926,home,1610612752,NYK,86,away,1610612754,IND,92,6,-6,1610612752,1610612754,"(201160, 200745, 203501, 204038, 203921)","(101139, 2561, 201588, 201579, 203524)",True
923,0021400927,home,1610612755,PHI,92,away,1610612737,ATL,84,-8,8,1610612755,1610612737,"(203496, 201601, 203960, 203477, 203457)","(201952, 203145, 203098, 203488, 201143)",True
924,0021400928,home,1610612750,MIN,121,away,1610612757,POR,113,8,-8,1610612750,1610612757,"(203952, 201937, 2755, 708, 201593)","(201577, 200746, 201587, 203081, 201167)",False
925,0021400929,home,1610612749,MIL,91,away,1610612764,WAS,85,6,-6,1610612749,1610612764,"(2585, 203114, 203507, 101141, 203487)","(203490, 2403, 202322, 101162, 1718)",False
926,0021400930,home,1610612743,DEN,100,away,1610612745,HOU,114,-14,14,1610612743,1610612745,"(201568, 201163, 201951, 202702, 200751)","(201976, 2772, 202700, 203093, 201935)",False
927,0021400931,home,1610612759,SAS,116,away,1610612741,CHI,105,-11,11,1610612759,1610612741,"(201168, 2225, 1495, 201980, 202695)","(2200, 2399, 201149, 201166, 203503)",True
928,0021400932,home,1610612744,GSW,106,away,1610612746,LAC,98,8,-8,1610612744,1610612746,"(201939, 101106, 202691, 203084, 203110)","(2440, 200755, 101108, 201150, 201599)",False
929,0021400933,home,1610612751,BKN,88,away,1610612762,UTA,95,-7,7,1610612751,1610612762,"(201152, 203900, 101114, 201572, 2207)","(203497, 202330, 202324, 203957, 204060)",False
930,0021400934,home,1610612765,DET,101,away,1610612766,CHA,108,7,-7,1610612765,1610612766,"(202704, 202328, 2419, 203083, 203484)","(2744, 201945, 203077, 2590, 203469)",True
931,0021400935,home,1610612753,ORL,103,away,1610612738,BOS,98,-5,5,1610612753,1610612738,"(101112, 203473, 203506, 202699, 203901)","(101138, 202323, 203092, 203109, 203935)",True
932,0021400936,home,1610612760,OKC,108,away,1610612761,TOR,104,4,-4,1610612760,1610612761,"(202713, 201586, 202683, 203460, 201566)","(200768, 101161, 203082, 202685, 201942)",False
933,0021400937,home,1610612747,LAL,93,away,1610612742,DAL,100,7,-7,1610612747,1610612742,"(201961, 203903, 204028, 201941, 202325)","(101145, 1717, 200765, 202718, 2199)",True
934,0021400938,home,1610612766,CHA,69,away,1610612764,WAS,95,-26,26,1610612766,1610612764,"(2744, 201945, 203077, 2590, 203469)","(101162, 2403, 202322, 203078, 1718)",False
935,0021400939,home,1610612737,ATL,130,away,1610612758,SAC,105,25,-25,1610612737,1610612758,"(201952, 201960, 2594, 200794, 201143)","(200752, 201171, 203492, 202326, 203463)",False
936,0021400940,home,1610612748,MIA,90,away,1610612738,BOS,100,10,-10,1610612748,1610612738,"(2736, 2548, 201596, 202355, 201611)","(101138, 202323, 203092, 203109, 203935)",True
937,0021400941,home,1610612741,CHI,91,away,1610612763,MEM,101,-10,10,1610612741,1610612763,"(2200, 2399, 201149, 201166, 203503)","(2216, 201584, 201144, 201188, 201145)",False
938,0021400942,home,1610612749,MIL,103,away,1610612740,NOP,114,-11,11,1610612749,1610612740,"(2585, 203114, 203507, 101141, 203487)","(201600, 201569, 201936, 202347, 203076)",False
939,0021400943,home,1610612743,DEN,106,away,1610612752,NYK,78,28,-28,1610612743,1610612752,"(201568, 201163, 201951, 202702, 200751)","(201160, 200745, 202498, 203144, 204038)",False
940,0021400944,home,1610612756,PHX,80,away,1610612744,GSW,98,18,-18,1610612756,1610612744,"(202688, 203458, 202339, 202693, 200782)","(202691, 101106, 201939, 203084, 203110)",True
941,0021400945,home,1610612746,LAC,89,away,1610612750,MIN,76,13,-13,1610612746,1610612750,"(2440, 200755, 101108, 201150, 201599)","(203952, 201937, 2755, 203940, 201593)",False
942,0021400946,home,1610612754,IND,118,away,1610612753,ORL,86,32,-32,1610612754,1610612753,"(2561, 201588, 201579, 203524, 204014)","(202696, 203473, 203506, 202699, 203901)",False
943,0021400947,home,1610612751,BKN,91,away,1610612740,NOP,111,-20,20,1610612751,1610612740,"(201152, 203900, 101114, 201572, 2207)","(201600, 201569, 202708, 202347, 203076)",False
944,0021400948,home,1610612742,DAL,94,away,1610612739,CLE,127,33,-33,1610612742,1610612739,"(202718, 101145, 1717, 200765, 2199)","(2544, 202681, 2747, 202389, 201567)",True
945,0021400949,home,1610612759,SAS,117,away,1610612761,TOR,107,10,-10,1610612759,1610612761,"(201168, 2225, 1495, 201980, 202695)","(200768, 101161, 203082, 202685, 201942)",False
946,0021400950,home,1610612762,UTA,87,away,1610612752,NYK,82,-5,5,1610612762,1610612752,"(203504, 203497, 202324, 203957, 202407)","(203144, 200745, 202498, 200811, 204038)",True
947,0021400951,home,1610612747,LAL,93,away,1610612765,DET,85,-8,8,1610612747,1610612765,"(201961, 201941, 204028, 202325, 203903)","(202704, 202328, 2419, 203083, 203484)",True
948,0021400952,home,1610612766,CHA,106,away,1610612758,SAC,113,-7,7,1610612766,1610612758,"(2744, 201945, 101107, 203077, 2590)","(200752, 201171, 203492, 202326, 203463)",False
949,0021400953,home,1610612755,PHI,95,away,1610612741,CHI,104,9,-9,1610612755,1610612741,"(203960, 201601, 2202, 202397, 203457)","(2200, 2399, 202703, 201166, 203503)",True
950,0021400954,home,1610612738,BOS,95,away,1610612763,MEM,92,3,-3,1610612738,1610612763,"(202340, 101138, 202323, 203092, 203935)","(2216, 201584, 201144, 201188, 201145)",False
951,0021400955,home,1610612748,MIA,104,away,1610612751,BKN,98,-6,6,1610612748,1610612751,"(2736, 201609, 201611, 2548, 2365)","(201152, 203900, 101114, 201572, 2207)",True
952,0021400956,home,1610612749,MIL,97,away,1610612753,ORL,91,6,-6,1610612749,1610612753,"(2585, 203114, 203507, 101141, 203487)","(202696, 203473, 203506, 202699, 203901)",False
953,0021400957,home,1610612760,OKC,108,away,1610612746,LAC,120,12,-12,1610612760,1610612746,"(202713, 201586, 202683, 203460, 201566)","(2440, 200755, 101108, 201150, 201599)",True
954,0021400958,home,1610612743,DEN,115,away,1610612737,ATL,102,-13,13,1610612743,1610612737,"(201568, 201163, 201951, 202702, 200751)","(201952, 201960, 2594, 200794, 201143)",True
955,0021400959,home,1610612756,PHX,106,away,1610612750,MIN,97,-9,9,1610612756,1610612750,"(203458, 202339, 200782, 202693, 202694)","(203952, 201937, 2755, 203940, 201593)",True
956,0021400960,home,1610612744,GSW,105,away,1610612765,DET,98,-7,7,1610612744,1610612765,"(201939, 101106, 202691, 203084, 203110)","(202704, 202328, 203083, 203484, 2406)",True
957,0021400961,home,1610612757,POR,105,away,1610612745,HOU,100,-5,5,1610612757,1610612745,"(201577, 200746, 201587, 203081, 201167)","(201976, 2772, 202700, 203093, 201935)",True
958,0021400962,home,1610612754,IND,109,away,1610612749,MIL,103,6,-6,1610612754,1610612749,"(2561, 201588, 101139, 203524, 101133)","(2585, 203114, 203507, 101141, 203487)",False
959,0021400963,home,1610612764,WAS,107,away,1610612763,MEM,87,-20,20,1610612764,1610612763,"(2400, 101162, 202322, 203078, 1718)","(201584, 201585, 203210, 2757, 201145)",True
960,0021400964,home,1610612759,SAS,125,away,1610612739,CLE,128,3,-3,1610612759,1610612739,"(201168, 2225, 1495, 201980, 202695)","(2544, 202681, 2747, 202389, 201567)",True
961,0021400965,home,1610612762,UTA,109,away,1610612745,HOU,91,-18,18,1610612762,1610612745,"(203497, 202330, 202324, 203957, 203918)","(201976, 2772, 202700, 203093, 201935)",True
962,0021400966,home,1610612747,LAL,94,away,1610612752,NYK,101,-7,7,1610612747,1610612752,"(201961, 203903, 204028, 202325, 201941)","(203144, 200745, 202498, 200811, 204038)",False
963,0021400967,home,1610612766,CHA,101,away,1610612741,CHI,91,10,-10,1610612766,1610612741,"(201945, 101107, 203077, 2590, 202687)","(2200, 2399, 201149, 201166, 203503)",False
964,0021400968,home,1610612755,PHI,114,away,1610612758,SAC,107,7,-7,1610612755,1610612758,"(203496, 201601, 203960, 203477, 203457)","(200752, 201171, 203492, 202326, 203463)",False
965,0021400969,home,1610612738,BOS,95,away,1610612753,ORL,88,7,-7,1610612738,1610612753,"(203092, 101138, 202323, 202340, 203935)","(202696, 203473, 203506, 202699, 203901)",False
966,0021400970,home,1610612761,TOR,102,away,1610612748,MIA,92,-10,10,1610612761,1610612748,"(200768, 101161, 203082, 201946, 201942)","(2736, 201609, 201611, 2548, 202355)",True
967,0021400971,home,1610612760,OKC,113,away,1610612750,MIN,99,-14,14,1610612760,1610612750,"(203956, 202683, 203460, 201566, 203079)","(203952, 201937, 2755, 203476, 203940)",True
968,0021400972,home,1610612742,DAL,129,away,1610612746,LAC,99,30,-30,1610612742,1610612746,"(202718, 101145, 1717, 200765, 2199)","(2440, 200755, 101108, 201150, 201599)",False
969,0021400973,home,1610612743,DEN,114,away,1610612744,GSW,103,11,-11,1610612743,1610612744,"(201568, 201163, 2749, 202702, 200751)","(203200, 203084, 2733, 203110, 101135)",False
970,0021400974,home,1610612756,PHX,87,away,1610612737,ATL,96,9,-9,1610612756,1610612737,"(203458, 202339, 200782, 202693, 202694)","(201952, 201960, 2594, 200794, 201143)",True
971,0021400975,home,1610612757,POR,118,away,1610612765,DET,99,-19,19,1610612757,1610612765,"(201577, 200746, 201587, 203081, 201167)","(202704, 202328, 203083, 203484, 2406)",True
972,0021400976,home,1610612754,IND,89,away,1610612738,BOS,93,4,-4,1610612754,1610612738,"(101139, 2561, 201588, 201579, 203524)","(202340, 101138, 202323, 203092, 203935)",True
973,0021400977,home,1610612764,WAS,113,away,1610612758,SAC,97,-16,16,1610612764,1610612758,"(2400, 101162, 202322, 203078, 1718)","(201956, 201171, 203492, 202326, 203463)",True
974,0021400978,home,1610612755,PHI,87,away,1610612751,BKN,94,7,-7,1610612755,1610612751,"(203960, 203457, 2202, 203924, 203477)","(201152, 203900, 101114, 201572, 2207)",True
975,0021400979,home,1610612763,MEM,96,away,1610612749,MIL,83,13,-13,1610612763,1610612749,"(2216, 201584, 201188, 2757, 201145)","(2585, 203114, 203507, 203898, 101141)",False
976,0021400980,home,1610612762,UTA,88,away,1610612765,DET,85,-3,3,1610612762,1610612765,"(203497, 202330, 202324, 203957, 203918)","(202704, 202328, 203083, 203484, 2406)",True
977,0021400981,home,1610612744,GSW,125,away,1610612752,NYK,94,31,-31,1610612744,1610612752,"(201939, 101106, 202691, 203084, 203110)","(203144, 200745, 202498, 200811, 204038)",False
978,0021400982,home,1610612760,OKC,109,away,1610612741,CHI,100,-9,9,1610612760,1610612741,"(203500, 202683, 203460, 201566, 203079)","(2200, 2399, 201149, 201166, 203503)",True
979,0021400983,home,1610612746,LAC,98,away,1610612745,HOU,100,2,-2,1610612746,1610612745,"(2440, 200755, 101108, 201933, 201599)","(201976, 2772, 202700, 203093, 201935)",True
980,0021400984,home,1610612740,NOP,111,away,1610612743,DEN,118,7,-7,1610612740,1610612743,"(201600, 201569, 201936, 202347, 203076)","(201568, 203994, 203914, 202702, 201951)",True
981,0021400985,home,1610612753,ORL,108,away,1610612739,CLE,123,15,-15,1610612753,1610612739,"(202696, 203473, 203506, 202699, 203901)","(2544, 202681, 2747, 202684, 202389)",True
982,0021400986,home,1610612759,SAS,123,away,1610612750,MIN,97,-26,26,1610612759,1610612750,"(201168, 2225, 1495, 201980, 202695)","(203952, 203120, 2755, 203476, 203897)",True
983,0021400987,home,1610612761,TOR,97,away,1610612757,POR,113,16,-16,1610612761,1610612757,"(200768, 101161, 203082, 202685, 201942)","(201577, 200746, 201587, 203081, 201167)",True
984,0021400988,home,1610612756,PHX,102,away,1610612752,NYK,89,-13,13,1610612756,1610612752,"(201148, 202339, 200782, 202693, 202694)","(203144, 200745, 202498, 200811, 204038)",True
985,0021400989,home,1610612747,LAL,86,away,1610612737,ATL,91,5,-5,1610612747,1610612737,"(201961, 201941, 204028, 202325, 203903)","(203544, 203145, 2594, 201143, 203471)",True
986,0021400990,home,1610612754,IND,98,away,1610612761,TOR,117,-19,19,1610612754,1610612761,"(101139, 2561, 201588, 201579, 203524)","(200768, 101161, 203082, 202685, 201942)",False
987,0021400991,home,1610612764,WAS,105,away,1610612757,POR,97,-8,8,1610612764,1610612757,"(101162, 2403, 202322, 203078, 1718)","(201577, 200746, 201587, 203081, 201167)",True
988,0021400992,home,1610612738,BOS,108,away,1610612755,PHI,89,19,-19,1610612738,1610612755,"(203092, 101138, 202323, 202340, 203935)","(201601, 203138, 203477, 2202, 203457)",False
989,0021400993,home,1610612763,MEM,92,away,1610612743,DEN,81,-11,11,1610612763,1610612743,"(2216, 201584, 201188, 2757, 201145)","(2749, 203994, 201163, 201589, 200751)",True
990,0021400994,home,1610612750,MIN,106,away,1610612751,BKN,122,16,-16,1610612750,1610612751,"(203952, 203897, 2755, 203476, 203940)","(201152, 203900, 101114, 201572, 2207)",True
991,0021400995,home,1610612748,MIA,106,away,1610612739,CLE,92,-14,14,1610612748,1610612739,"(2736, 201609, 202355, 2548, 2617)","(2544, 202681, 2747, 202684, 202389)",True
992,0021400996,home,1610612742,DAL,119,away,1610612760,OKC,115,4,-4,1610612742,1610612760,"(101145, 1717, 200765, 202718, 2199)","(203500, 202683, 203460, 201566, 203079)",False
993,0021400997,home,1610612762,UTA,94,away,1610612766,CHA,66,-28,28,1610612762,1610612766,"(203497, 202330, 202324, 203957, 203918)","(2744, 201945, 101107, 203077, 2590)",True
994,0021400998,home,1610612758,SAC,103,away,1610612737,ATL,110,7,-7,1610612758,1610612737,"(201956, 201171, 203492, 202326, 203463)","(201952, 201960, 1882, 200794, 203145)",True
995,0021401000,home,1610612765,DET,105,away,1610612763,MEM,95,10,-10,1610612765,1610612763,"(202704, 203083, 203484, 201229, 2406)","(201584, 2216, 201188, 2757, 201145)",False
996,0021401001,home,1610612752,NYK,104,away,1610612759,SAS,100,4,-4,1610612752,1610612759,"(203144, 200745, 202498, 200811, 204038)","(201168, 2225, 1495, 201980, 202695)",False
997,0021401002,home,1610612745,HOU,107,away,1610612753,ORL,94,13,-13,1610612745,1610612753,"(201976, 2772, 201595, 202700, 201935)","(202696, 203473, 203506, 202699, 203901)",False
998,0021401003,home,1610612740,NOP,85,away,1610612749,MIL,84,-1,1,1610612740,1610612749,"(201600, 201569, 201936, 202347, 203076)","(2585, 203114, 203507, 101141, 203487)",True
999,0021401004,home,1610612746,LAC,99,away,1610612766,CHA,92,-7,7,1610612746,1610612766,"(201599, 200755, 101108, 201933, 2045)","(2744, 201945, 101107, 203077, 2590)",True
1000,0021401005,home,1610612739,CLE,117,away,1610612751,BKN,92,-25,25,1610612739,1610612751,"(2544, 202681, 2747, 202389, 201567)","(201152, 203900, 101114, 201572, 2207)",True
1001,0021401006,home,1610612755,PHI,94,away,1610612765,DET,83,-11,11,1610612755,1610612765,"(203960, 201601, 2202, 202397, 203457)","(202704, 203083, 203484, 201229, 2406)",True
1002,0021401007,home,1610612748,MIA,108,away,1610612757,POR,104,4,-4,1610612748,1610612757,"(2736, 201609, 202355, 2548, 2617)","(201577, 200746, 201587, 203081, 201167)",False
1003,0021401008,home,1610612761,TOR,105,away,1610612750,MIN,100,-5,5,1610612761,1610612750,"(200768, 101161, 203082, 202685, 201942)","(203952, 201937, 2755, 203940, 203476)",True
1004,0021401009,home,1610612741,CHI,103,away,1610612754,IND,86,17,-17,1610612741,1610612754,"(2200, 2399, 201149, 201166, 203503)","(101139, 2561, 201588, 201579, 203524)",False
1005,0021401010,home,1610612749,MIL,103,away,1610612759,SAS,114,-11,11,1610612749,1610612759,"(2585, 203114, 203507, 101141, 203487)","(201168, 2225, 1495, 201980, 202695)",False
1006,0021401011,home,1610612760,OKC,122,away,1610612738,BOS,118,-4,4,1610612760,1610612738,"(203500, 202683, 203460, 201566, 203079)","(202340, 101138, 202323, 203092, 203935)",True
1007,0021401012,home,1610612742,DAL,107,away,1610612753,ORL,102,5,-5,1610612742,1610612753,"(202718, 101145, 1717, 200765, 2199)","(202696, 101112, 203506, 203090, 203901)",False
1008,0021401013,home,1610612758,SAC,105,away,1610612746,LAC,116,11,-11,1610612758,1610612746,"(200752, 203492, 200797, 201574, 203463)","(201599, 200755, 101108, 201933, 2045)",True
1009,0021401014,home,1610612744,GSW,114,away,1610612737,ATL,95,-19,19,1610612744,1610612737,"(203200, 101106, 201939, 203084, 203110)","(201952, 201960, 200794, 201143, 203145)",True
1010,0021401015,home,1610612762,UTA,84,away,1610612764,WAS,88,-4,4,1610612762,1610612764,"(203497, 202330, 202324, 203957, 203918)","(101162, 2403, 202322, 203078, 1718)",False
1011,0021401016,home,1610612752,NYK,92,away,1610612750,MIN,95,3,-3,1610612752,1610612750,"(203144, 200745, 202498, 200811, 204038)","(203952, 203476, 2755, 203940, 203897)",True
1012,0021401017,home,1610612745,HOU,118,away,1610612743,DEN,108,-10,10,1610612745,1610612743,"(201976, 2772, 202700, 203093, 201935)","(201568, 201163, 201951, 202702, 200751)",True
1013,0021401018,home,1610612756,PHX,74,away,1610612740,NOP,72,-2,2,1610612756,1610612740,"(201148, 202339, 200782, 202693, 202694)","(201600, 201569, 202347, 201936, 201967)",True
1014,0021401019,home,1610612747,LAL,73,away,1610612762,UTA,80,-7,7,1610612747,1610612762,"(201961, 203903, 204028, 201941, 202325)","(203497, 202330, 202324, 203957, 203918)",False
1015,0021401020,home,1610612753,ORL,111,away,1610612757,POR,104,7,-7,1610612753,1610612757,"(202696, 101112, 203506, 203090, 203901)","(201577, 200746, 201587, 203081, 201167)",False
1016,0021401021,home,1610612755,PHI,97,away,1610612752,NYK,81,-16,16,1610612755,1610612752,"(203960, 201601, 2202, 202397, 203457)","(203144, 200745, 202498, 200811, 204038)",True
1017,0021401022,home,1610612751,BKN,129,away,1610612749,MIL,127,2,-2,1610612751,1610612749,"(201152, 203900, 101114, 201572, 2207)","(2585, 203114, 203507, 101141, 203487)",False
1018,0021401023,home,1610612739,CLE,95,away,1610612754,IND,92,3,-3,1610612739,1610612754,"(2544, 202681, 2747, 202389, 201567)","(101139, 2561, 201588, 201579, 203524)",False
1019,0021401024,home,1610612748,MIA,108,away,1610612743,DEN,91,-17,17,1610612748,1610612743,"(2736, 201609, 202355, 2548, 2617)","(203994, 201163, 201951, 202702, 200751)",True
1020,0021401025,home,1610612741,CHI,108,away,1610612761,TOR,92,16,-16,1610612741,1610612761,"(2200, 2399, 201149, 201166, 203503)","(101161, 203082, 202349, 201942, 202685)",False
1021,0021401026,home,1610612760,OKC,123,away,1610612737,ATL,115,-8,8,1610612760,1610612737,"(203500, 203956, 203460, 201566, 203079)","(201952, 201960, 200794, 201143, 203145)",True
1022,0021401027,home,1610612742,DAL,101,away,1610612763,MEM,112,-11,11,1610612742,1610612763,"(202718, 101145, 1717, 200765, 2199)","(2216, 201584, 2754, 201144, 201188)",False
1023,0021401028,home,1610612759,SAS,101,away,1610612738,BOS,89,-12,12,1610612759,1610612738,"(201168, 2225, 1495, 201980, 202695)","(203092, 101138, 202323, 202340, 203935)",True
1024,0021401029,home,1610612758,SAC,101,away,1610612766,CHA,91,-10,10,1610612758,1610612766,"(200752, 201956, 203492, 201574, 203463)","(2744, 202689, 201945, 203077, 203469)",True
1025,0021401030,home,1610612744,GSW,112,away,1610612740,NOP,96,16,-16,1610612744,1610612740,"(203200, 101106, 201939, 203084, 203110)","(201936, 201569, 202347, 201582, 201967)",False
1026,0021401031,home,1610612746,LAC,113,away,1610612764,WAS,99,14,-14,1610612746,1610612764,"(2440, 200755, 101108, 201933, 201599)","(101162, 2403, 202322, 203078, 1718)",False
1027,0021401032,home,1610612754,IND,111,away,1610612751,BKN,123,12,-12,1610612754,1610612751,"(101139, 2561, 201588, 201579, 203524)","(201152, 203900, 101114, 201572, 2207)",True
1028,0021401033,home,1610612765,DET,107,away,1610612741,CHI,91,-16,16,1610612765,1610612741,"(202704, 203083, 203484, 201229, 2406)","(2200, 2399, 201149, 201166, 203503)",True
1029,0021401034,home,1610612745,HOU,102,away,1610612756,PHX,117,-15,15,1610612745,1610612756,"(201976, 2772, 201595, 202700, 201935)","(203458, 202339, 200782, 202693, 202694)",False
1030,0021401035,home,1610612763,MEM,97,away,1610612757,POR,86,11,-11,1610612763,1610612757,"(2216, 201144, 2754, 201188, 201145)","(201577, 200746, 201587, 203081, 201167)",False
1031,0021401036,home,1610612744,GSW,106,away,1610612762,UTA,91,15,-15,1610612744,1610612762,"(203200, 101106, 201939, 203084, 203110)","(203497, 202330, 202324, 203957, 203918)",False
1032,0021401037,home,1610612749,MIL,90,away,1610612739,CLE,108,18,-18,1610612749,1610612739,"(2585, 203114, 203507, 101141, 203487)","(2544, 202681, 2747, 202389, 201567)",True
1033,0021401038,home,1610612760,OKC,93,away,1610612748,MIA,75,-18,18,1610612760,1610612748,"(203500, 202683, 203460, 201566, 203079)","(2736, 201609, 202355, 2548, 2617)",True
1034,0021401039,home,1610612737,ATL,95,away,1610612759,SAS,114,-19,19,1610612737,1610612759,"(201952, 201960, 2594, 200794, 201143)","(201168, 2225, 1495, 201980, 202695)",False
1035,0021401040,home,1610612746,LAC,107,away,1610612740,NOP,100,7,-7,1610612746,1610612740,"(2440, 200755, 101108, 201933, 201599)","(202708, 202347, 203076, 201582, 201967)",False
1036,0021401041,home,1610612761,TOR,106,away,1610612752,NYK,89,-17,17,1610612761,1610612752,"(101161, 203082, 202349, 201942, 202685)","(203144, 200745, 202498, 200811, 204038)",True
1037,0021401042,home,1610612758,SAC,109,away,1610612764,WAS,86,23,-23,1610612758,1610612764,"(200752, 203492, 201956, 202326, 203463)","(101162, 2403, 202322, 203078, 1718)",False
1038,0021401043,home,1610612738,BOS,97,away,1610612765,DET,105,-8,8,1610612738,1610612765,"(203092, 101138, 202323, 202340, 203109)","(202704, 203083, 203484, 201229, 2406)",False
1039,0021401044,home,1610612753,ORL,100,away,1610612743,DEN,119,19,-19,1610612753,1610612743,"(202696, 203506, 203090, 203094, 203901)","(201568, 203994, 201163, 202702, 201951)",True
1040,0021401045,home,1610612750,MIN,98,away,1610612766,CHA,109,11,-11,1610612750,1610612766,"(203952, 203476, 2755, 203940, 203897)","(2744, 202689, 101107, 203077, 201945)",True
1041,0021401046,home,1610612756,PHX,98,away,1610612742,DAL,92,-6,6,1610612756,1610612742,"(203458, 202339, 200782, 202693, 202694)","(202718, 101145, 1717, 200765, 2199)",True
1042,0021401047,home,1610612747,LAL,101,away,1610612755,PHI,87,14,-14,1610612747,1610612755,"(201961, 203903, 204028, 202325, 201941)","(203960, 201601, 2202, 202397, 203457)",False
1043,0021401048,home,1610612754,IND,100,away,1610612745,HOU,110,10,-10,1610612754,1610612745,"(101139, 2561, 201588, 201579, 203524)","(201976, 2772, 201595, 202700, 201935)",True
1044,0021401049,home,1610612751,BKN,91,away,1610612738,BOS,110,-19,19,1610612751,1610612738,"(201152, 203900, 101114, 201572, 2207)","(203092, 101138, 202323, 202340, 203935)",False
1045,0021401050,home,1610612752,NYK,82,away,1610612763,MEM,103,21,-21,1610612752,1610612763,"(200745, 202498, 203499, 200811, 204038)","(2216, 201144, 2754, 201188, 201145)",True
1046,0021401051,home,1610612741,CHI,98,away,1610612766,CHA,86,-12,12,1610612741,1610612766,"(2200, 2399, 202710, 201166, 201959)","(2744, 202689, 101107, 203077, 201945)",True
1047,0021401052,home,1610612762,UTA,104,away,1610612750,MIN,106,2,-2,1610612762,1610612750,"(203497, 204060, 202324, 203957, 203918)","(203952, 203476, 203940, 203485, 203897)",True
1048,0021401053,home,1610612744,GSW,107,away,1610612764,WAS,76,31,-31,1610612744,1610612764,"(202691, 101106, 201939, 203084, 203110)","(101162, 2403, 202322, 203078, 1718)",False
1049,0021401054,home,1610612765,DET,108,away,1610612761,TOR,104,4,-4,1610612765,1610612761,"(202704, 203083, 203484, 201229, 2406)","(200768, 101161, 203082, 202685, 201942)",False
1050,0021401055,home,1610612749,MIL,89,away,1610612748,MIA,88,-1,1,1610612749,1610612748,"(2585, 203114, 203507, 101141, 203487)","(2736, 201609, 202355, 2548, 2617)",True
1051,0021401056,home,1610612760,OKC,127,away,1610612747,LAL,117,-10,10,1610612760,1610612747,"(202713, 202683, 203500, 201566, 203079)","(203903, 202391, 204028, 202325, 203527)",True
1052,0021401057,home,1610612742,DAL,101,away,1610612759,SAS,94,7,-7,1610612742,1610612759,"(202718, 101145, 1717, 200765, 2199)","(201168, 2225, 1495, 201980, 202695)",False
1053,0021401058,home,1610612758,SAC,107,away,1610612755,PHI,106,-1,1,1610612758,1610612755,"(200752, 201956, 203492, 202326, 203463)","(203496, 201601, 203960, 202397, 203457)",True
1054,0021401059,home,1610612757,POR,108,away,1610612744,GSW,122,14,-14,1610612757,1610612744,"(201577, 201167, 2748, 203081, 202087)","(201939, 101106, 202691, 203084, 203110)",True
1055,0021401060,home,1610612766,CHA,88,away,1610612751,BKN,91,3,-3,1610612766,1610612751,"(2744, 202689, 101107, 203077, 201945)","(201152, 203900, 101114, 201572, 2207)",True
1056,0021401061,home,1610612752,NYK,80,away,1610612746,LAC,111,31,-31,1610612752,1610612746,"(200745, 202498, 200811, 204038, 203499)","(2440, 200755, 101108, 201933, 201599)",True
1057,0021401062,home,1610612753,ORL,83,away,1610612737,ATL,95,12,-12,1610612753,1610612737,"(202696, 203473, 203506, 202699, 203901)","(201952, 201960, 2594, 200794, 201143)",True
1058,0021401063,home,1610612764,WAS,101,away,1610612754,IND,103,2,-2,1610612764,1610612754,"(101162, 2403, 202322, 203078, 1718)","(101139, 2561, 201588, 201579, 203524)",True
1059,0021401064,home,1610612738,BOS,86,away,1610612748,MIA,93,-7,7,1610612738,1610612748,"(203092, 101138, 202323, 202340, 203935)","(2736, 201609, 201611, 201596, 2617)",False
1060,0021401065,home,1610612761,TOR,103,away,1610612741,CHI,116,13,-13,1610612761,1610612741,"(101161, 203082, 202349, 201942, 202685)","(2200, 2399, 202710, 201166, 201149)",True
1061,0021401066,home,1610612763,MEM,89,away,1610612739,CLE,111,22,-22,1610612763,1610612739,"(201584, 2216, 2754, 201144, 201188)","(2544, 202681, 2747, 202389, 201567)",True
1062,0021401067,home,1610612750,MIN,99,away,1610612747,LAL,101,2,-2,1610612750,1610612747,"(203952, 203476, 203940, 203485, 203897)","(203903, 202391, 204028, 202325, 203527)",True
1063,0021401068,home,1610612740,NOP,93,away,1610612745,HOU,95,2,-2,1610612740,1610612745,"(201600, 201569, 201936, 202347, 203076)","(2772, 2730, 1891, 202700, 201935)",True
1064,0021401069,home,1610612743,DEN,85,away,1610612755,PHI,99,-14,14,1610612743,1610612755,"(201568, 201163, 201951, 202702, 200751)","(203960, 203457, 2202, 203924, 202397)",False
1065,0021401070,home,1610612762,UTA,89,away,1610612757,POR,92,3,-3,1610612762,1610612757,"(203504, 203497, 202324, 203957, 202407)","(201577, 200746, 203459, 203081, 201167)",True
1066,0021401071,home,1610612759,SAS,130,away,1610612760,OKC,91,-39,39,1610612759,1610612760,"(201168, 2225, 1495, 201980, 202695)","(202713, 202683, 203500, 201566, 203079)",True
1067,0021401072,home,1610612756,PHX,99,away,1610612758,SAC,108,-9,9,1610612756,1610612758,"(203458, 202339, 200782, 202693, 202694)","(200752, 203492, 201956, 202326, 203463)",False
1068,0021401073,home,1610612749,MIL,111,away,1610612754,IND,107,-4,4,1610612749,1610612754,"(2585, 203114, 203507, 101141, 203487)","(101139, 2449, 201588, 201579, 203524)",True
1069,0021401074,home,1610612753,ORL,97,away,1610612765,DET,111,14,-14,1610612753,1610612765,"(202696, 203506, 202699, 203901, 203094)","(202704, 203083, 203484, 201229, 2406)",True
1070,0021401075,home,1610612755,PHI,98,away,1610612746,LAC,119,21,-21,1610612755,1610612746,"(203496, 203457, 203960, 203924, 202397)","(2440, 200755, 101108, 201933, 201599)",True
1071,0021401076,home,1610612764,WAS,110,away,1610612766,CHA,107,-3,3,1610612764,1610612766,"(101162, 2403, 202322, 203078, 1718)","(2744, 202689, 101107, 203077, 201945)",True
1072,0021401077,home,1610612737,ATL,99,away,1610612748,MIA,86,13,-13,1610612737,1610612748,"(201960, 2594, 201143, 200794, 203471)","(2736, 201609, 201611, 2548, 2617)",False
1073,0021401078,home,1610612751,BKN,106,away,1610612739,CLE,98,8,-8,1610612751,1610612739,"(203900, 101114, 201572, 203486, 2207)","(2544, 202681, 2747, 202389, 201567)",False
1074,0021401079,home,1610612752,NYK,92,away,1610612738,BOS,96,4,-4,1610612752,1610612738,"(200745, 202498, 203499, 200811, 204038)","(203092, 101138, 202323, 202340, 203935)",True
1075,0021401080,home,1610612761,TOR,94,away,1610612747,LAL,83,-11,11,1610612761,1610612747,"(101161, 203082, 202349, 201942, 202685)","(203903, 202391, 204028, 202325, 203527)",True
1076,0021401081,home,1610612745,HOU,120,away,1610612750,MIN,110,10,-10,1610612745,1610612750,"(2730, 1891, 2772, 2746, 201935)","(203952, 203897, 203476, 203940, 203485)",False
1077,0021401082,home,1610612763,MEM,84,away,1610612744,GSW,107,23,-23,1610612763,1610612744,"(2216, 201584, 2754, 201144, 201188)","(201939, 101106, 202691, 203084, 203110)",True
1078,0021401083,home,1610612740,NOP,102,away,1610612758,SAC,88,14,-14,1610612740,1610612758,"(201600, 201569, 202347, 201936, 203076)","(200752, 203492, 201956, 202326, 203463)",False
1079,0021401084,home,1610612759,SAS,94,away,1610612742,DAL,76,-18,18,1610612759,1610612742,"(201168, 2225, 1495, 201980, 202695)","(202718, 101145, 1717, 200765, 2199)",True
1080,0021401085,home,1610612743,DEN,107,away,1610612762,UTA,91,16,-16,1610612743,1610612762,"(201568, 201163, 201951, 202702, 200751)","(203497, 202330, 202324, 203957, 204060)",False
1081,0021401086,home,1610612756,PHX,81,away,1610612757,POR,87,-6,6,1610612756,1610612757,"(203458, 202339, 200782, 202693, 202694)","(201577, 200746, 201587, 203081, 201167)",False
1082,0021401087,home,1610612766,CHA,115,away,1610612737,ATL,100,-15,15,1610612766,1610612737,"(2744, 202689, 203106, 101107, 201945)","(203488, 203145, 1882, 203098, 203471)",True
1083,0021401088,home,1610612741,CHI,111,away,1610612752,NYK,80,31,-31,1610612741,1610612752,"(2200, 2399, 202710, 201166, 201149)","(200745, 202498, 203499, 200811, 204038)",False
1084,0021401089,home,1610612749,MIL,95,away,1610612744,GSW,108,13,-13,1610612749,1610612744,"(2585, 203114, 203507, 101141, 203487)","(101106, 202691, 203084, 201939, 101135)",True
1085,0021401090,home,1610612762,UTA,94,away,1610612760,OKC,89,-5,5,1610612762,1610612760,"(202344, 203497, 202330, 203957, 203918)","(202713, 202683, 203500, 201566, 203079)",True
1086,0021401091,home,1610612757,POR,120,away,1610612743,DEN,114,-6,6,1610612757,1610612743,"(201577, 200746, 201587, 203081, 201167)","(201163, 201951, 201581, 202702, 200751)",True
1087,0021401092,home,1610612739,CLE,87,away,1610612755,PHI,86,1,-1,1610612739,1610612755,"(2544, 202681, 2747, 202389, 201567)","(203496, 203457, 203128, 203924, 202397)",False
1088,0021401093,home,1610612751,BKN,107,away,1610612747,LAL,99,8,-8,1610612751,1610612747,"(203900, 101114, 201572, 203486, 2207)","(201961, 203903, 204028, 202325, 203527)",False
1089,0021401094,home,1610612740,NOP,110,away,1610612750,MIN,88,-22,22,1610612740,1610612750,"(201600, 201569, 202347, 201936, 203076)","(203952, 203476, 203940, 203485, 203897)",True
1090,0021401095,home,1610612738,BOS,106,away,1610612746,LAC,119,-13,13,1610612738,1610612746,"(203092, 101138, 202323, 202340, 203935)","(2440, 200755, 101108, 201933, 201599)",False
1091,0021401096,home,1610612748,MIA,109,away,1610612765,DET,102,-7,7,1610612748,1610612765,"(2736, 201609, 201611, 2548, 2617)","(202704, 203083, 203484, 201229, 2406)",True
1092,0021401097,home,1610612764,WAS,91,away,1610612745,HOU,99,8,-8,1610612764,1610612745,"(101162, 2403, 202322, 203078, 1718)","(2746, 1891, 2772, 2730, 201935)",True
1093,0021401098,home,1610612759,SAS,103,away,1610612763,MEM,89,-14,14,1610612759,1610612763,"(201168, 2225, 1495, 201980, 202695)","(2216, 201584, 201144, 201188, 1713)",True
1094,0021401099,home,1610612754,IND,104,away,1610612742,DAL,99,-5,5,1610612754,1610612742,"(101139, 2561, 201588, 201579, 203524)","(202718, 2210, 1717, 200765, 2199)",True
1095,0021401100,home,1610612756,PHX,97,away,1610612760,OKC,109,12,-12,1610612756,1610612760,"(203458, 202339, 200782, 202693, 202694)","(202713, 202683, 203500, 201566, 203079)",True
1096,0021401101,home,1610612766,CHA,104,away,1610612738,BOS,116,12,-12,1610612766,1610612738,"(2744, 202689, 203106, 101107, 201945)","(203092, 101138, 202323, 202340, 203935)",True
1097,0021401102,home,1610612755,PHI,111,away,1610612747,LAL,113,2,-2,1610612755,1610612747,"(203496, 203457, 203960, 203128, 202397)","(201961, 203903, 204028, 202325, 203527)",True
1098,0021401103,home,1610612737,ATL,101,away,1610612749,MIL,88,13,-13,1610612737,1610612749,"(201952, 201960, 2594, 200794, 201143)","(2585, 203114, 203507, 101141, 203487)",False
1099,0021401104,home,1610612761,TOR,99,away,1610612745,HOU,96,-3,3,1610612761,1610612745,"(101161, 203082, 202349, 201942, 202685)","(201595, 2746, 1891, 2772, 201935)",True
1100,0021401105,home,1610612763,MEM,97,away,1610612758,SAC,83,14,-14,1610612763,1610612758,"(2216, 201584, 201144, 201188, 201145)","(200752, 203492, 2501, 201574, 203463)",False
1101,0021401106,home,1610612750,MIN,84,away,1610612762,UTA,104,-20,20,1610612750,1610612762,"(203952, 203120, 203940, 203485, 203897)","(202344, 203497, 202330, 203957, 203918)",False
1102,0021401107,home,1610612757,POR,109,away,1610612756,PHX,86,-23,23,1610612757,1610612756,"(201577, 200746, 201587, 203081, 201167)","(203458, 202339, 200782, 202693, 202694)",True
1103,0021401108,home,1610612751,BKN,111,away,1610612754,IND,106,5,-5,1610612751,1610612754,"(201152, 203900, 101114, 201572, 2207)","(101139, 2561, 201588, 201579, 203524)",False
1104,0021401109,home,1610612765,DET,105,away,1610612737,ATL,95,-10,10,1610612765,1610612737,"(202704, 203083, 203484, 201229, 2406)","(201952, 201960, 2594, 200794, 201143)",True
1105,0021401110,home,1610612748,MIA,81,away,1610612759,SAS,95,-14,14,1610612748,1610612759,"(201609, 201611, 2548, 203516, 2365)","(201168, 2225, 1495, 201980, 202695)",False
1106,0021401111,home,1610612746,LAC,106,away,1610612744,GSW,110,4,-4,1610612746,1610612744,"(2440, 200755, 101108, 201933, 201599)","(101106, 202691, 203084, 201939, 101135)",True
1107,0021401112,home,1610612766,CHA,102,away,1610612765,DET,78,24,-24,1610612766,1610612765,"(2744, 202689, 203106, 101107, 201945)","(202704, 203083, 203484, 201229, 2406)",False
1108,0021401113,home,1610612753,ORL,91,away,1610612759,SAS,103,-12,12,1610612753,1610612759,"(202696, 203473, 203506, 202699, 203901)","(201168, 2225, 1495, 201980, 202695)",False
1109,0021401114,home,1610612764,WAS,106,away,1610612755,PHI,93,-13,13,1610612764,1610612755,"(203490, 2403, 202322, 101162, 203078)","(203128, 203457, 203960, 203924, 202397)",True
1110,0021401115,home,1610612738,BOS,100,away,1610612754,IND,87,13,-13,1610612738,1610612754,"(202340, 101138, 202323, 203092, 203935)","(101139, 2561, 201588, 201579, 203524)",False
1111,0021401116,home,1610612752,NYK,98,away,1610612751,BKN,100,2,-2,1610612752,1610612751,"(200745, 202498, 203499, 200811, 204038)","(201152, 203900, 101114, 201572, 2207)",True
1112,0021401117,home,1610612745,HOU,115,away,1610612758,SAC,111,4,-4,1610612745,1610612758,"(201595, 1891, 2772, 203093, 201935)","(203492, 201171, 201956, 202326, 203463)",False
1113,0021401118,home,1610612749,MIL,95,away,1610612741,CHI,91,-4,4,1610612749,1610612741,"(2585, 203114, 203507, 101141, 203487)","(2200, 2399, 202710, 201166, 201149)",True
1114,0021401119,home,1610612750,MIN,99,away,1610612761,TOR,113,-14,14,1610612750,1610612761,"(203120, 203952, 203940, 203485, 203897)","(101161, 203082, 202349, 201942, 202685)",False
1115,0021401120,home,1610612760,OKC,131,away,1610612742,DAL,135,4,-4,1610612760,1610612742,"(202713, 202683, 203500, 201566, 203079)","(101145, 1717, 200765, 202718, 2199)",True
1116,0021401121,home,1610612762,UTA,98,away,1610612743,DEN,84,-14,14,1610612762,1610612743,"(203497, 202330, 202324, 203957, 204060)","(201568, 201163, 201951, 202702, 200751)",True
1117,0021401122,home,1610612757,POR,122,away,1610612746,LAC,126,4,-4,1610612757,1610612746,"(201577, 200746, 201587, 203081, 201167)","(2440, 200755, 101108, 201933, 201599)",True
1118,0021401123,home,1610612747,LAL,92,away,1610612740,NOP,113,-21,21,1610612747,1610612740,"(203903, 202391, 204028, 202325, 203527)","(201600, 201569, 201936, 202347, 203076)",False
1119,0021401124,home,1610612739,CLE,114,away,1610612748,MIA,88,26,-26,1610612739,1610612748,"(2592, 2544, 2747, 202389, 202681)","(2736, 201609, 201611, 2548, 202355)",False
1120,0021401125,home,1610612742,DAL,101,away,1610612745,HOU,108,-7,7,1610612742,1610612745,"(101145, 1717, 200765, 202718, 2199)","(2730, 1891, 2772, 203093, 201935)",False
1121,0021401126,home,1610612744,GSW,107,away,1610612756,PHX,106,1,-1,1610612744,1610612756,"(101106, 201939, 203084, 202691, 101135)","(201148, 202339, 200782, 202693, 202694)",False
1122,0021401127,home,1610612754,IND,93,away,1610612766,CHA,74,-19,19,1610612754,1610612766,"(101139, 2561, 201588, 201579, 203524)","(2744, 202689, 203106, 101107, 201945)",True
1123,0021401128,home,1610612764,WAS,101,away,1610612752,NYK,87,-14,14,1610612764,1610612752,"(2400, 203490, 202322, 101162, 203078)","(200745, 202498, 203499, 200811, 204038)",True
1124,0021401129,home,1610612738,BOS,101,away,1610612749,MIL,110,-9,9,1610612738,1610612749,"(203092, 101138, 202323, 202340, 203935)","(2585, 203114, 203507, 101141, 203487)",False
1125,0021401130,home,1610612751,BKN,114,away,1610612761,TOR,109,5,-5,1610612751,1610612761,"(201152, 203900, 101114, 201572, 2207)","(101161, 203082, 202349, 201942, 202685)",False
1126,0021401131,home,1610612741,CHI,88,away,1610612765,DET,82,6,-6,1610612741,1610612765,"(2200, 2399, 202710, 201166, 201149)","(202704, 203083, 203484, 201229, 2406)",False
1127,0021401132,home,1610612763,MEM,100,away,1610612760,OKC,92,8,-8,1610612763,1610612760,"(2216, 201584, 201144, 201188, 201145)","(202713, 202683, 203500, 201566, 203079)",False
1128,0021401133,home,1610612750,MIN,84,away,1610612753,ORL,97,-13,13,1610612750,1610612753,"(203120, 203952, 2755, 203940, 203897)","(202696, 203473, 203506, 202699, 203901)",False
1129,0021401134,home,1610612759,SAS,123,away,1610612743,DEN,93,-30,30,1610612759,1610612743,"(201168, 2225, 1495, 201980, 202695)","(201568, 201163, 201951, 202702, 200751)",True
1130,0021401135,home,1610612758,SAC,95,away,1610612740,NOP,101,6,-6,1610612758,1610612740,"(201956, 201171, 203492, 202326, 203463)","(201600, 201569, 202347, 201936, 203076)",True
1131,0021401136,home,1610612747,LAL,77,away,1610612757,POR,107,-30,30,1610612747,1610612757,"(203903, 202391, 204028, 202325, 203527)","(201577, 200746, 201587, 203081, 201167)",False
1132,0021401137,home,1610612766,CHA,92,away,1610612755,PHI,91,1,-1,1610612766,1610612755,"(202689, 203106, 101107, 202687, 201945)","(203496, 203457, 203128, 203924, 202397)",False
1133,0021401138,home,1610612737,ATL,131,away,1610612751,BKN,99,32,-32,1610612737,1610612751,"(201952, 201960, 2594, 200794, 201143)","(201152, 203900, 101114, 201572, 2207)",False
1134,0021401139,home,1610612765,DET,99,away,1610612748,MIA,98,1,-1,1610612765,1610612748,"(202704, 203083, 203484, 201229, 2406)","(2736, 201609, 202355, 2548, 2617)",False
1135,0021401140,home,1610612761,TOR,116,away,1610612738,BOS,117,1,-1,1610612761,1610612738,"(201946, 203082, 202349, 201942, 202685)","(203092, 101138, 202323, 202340, 203935)",True
1136,0021401141,home,1610612763,MEM,83,away,1610612764,WAS,92,-9,9,1610612763,1610612764,"(2216, 201584, 201144, 201188, 201145)","(2400, 203490, 202322, 101162, 203078)",False
1137,0021401142,home,1610612742,DAL,110,away,1610612744,GSW,123,-13,13,1610612742,1610612744,"(101145, 2210, 1717, 200765, 2199)","(201939, 101106, 202691, 203084, 203110)",False
1138,0021401143,home,1610612749,MIL,90,away,1610612753,ORL,97,-7,7,1610612749,1610612753,"(2585, 203114, 203507, 101141, 203487)","(202696, 203473, 203506, 202699, 203901)",False
1139,0021401144,home,1610612743,DEN,92,away,1610612746,LAC,107,-15,15,1610612743,1610612746,"(2749, 201163, 201581, 202702, 200751)","(2440, 200755, 101108, 201933, 201599)",False
1140,0021401145,home,1610612756,PHX,87,away,1610612762,UTA,85,2,-2,1610612756,1610612762,"(201148, 202339, 200782, 202693, 202694)","(203497, 202330, 202324, 203957, 203918)",False
1141,0021401146,home,1610612757,POR,99,away,1610612740,NOP,90,-9,9,1610612757,1610612740,"(201577, 200746, 201587, 203081, 201167)","(201600, 201569, 201936, 202347, 203076)",True
1142,0021401147,home,1610612760,OKC,112,away,1610612745,HOU,115,3,-3,1610612760,1610612745,"(202713, 202683, 203500, 201566, 203079)","(2730, 1891, 2772, 203093, 201935)",True
1143,0021401148,home,1610612739,CLE,99,away,1610612741,CHI,94,-5,5,1610612739,1610612741,"(2544, 202681, 2747, 202389, 201567)","(2200, 2399, 202710, 201166, 201149)",True
1144,0021401149,home,1610612754,IND,112,away,1610612748,MIA,89,23,-23,1610612754,1610612748,"(101139, 2561, 201588, 201579, 203524)","(2736, 201609, 201611, 2548, 2617)",False
1145,0021401150,home,1610612759,SAS,107,away,1610612744,GSW,92,-15,15,1610612759,1610612744,"(2225, 1495, 201980, 2588, 202695)","(201939, 101106, 202691, 203084, 203110)",True
1146,0021401151,home,1610612752,NYK,101,away,1610612755,PHI,91,10,-10,1610612752,1610612755,"(200745, 202498, 203499, 200811, 204038)","(203496, 203457, 203128, 203924, 202397)",False
1147,0021401152,home,1610612758,SAC,95,away,1610612762,UTA,101,-6,6,1610612758,1610612762,"(203492, 201171, 201956, 202326, 203463)","(203497, 202330, 202324, 203957, 203918)",False
1148,0021401153,home,1610612747,LAL,78,away,1610612746,LAC,106,28,-28,1610612747,1610612746,"(203903, 202391, 204028, 202325, 203527)","(2440, 200755, 101108, 201933, 201599)",True
1149,0021401154,home,1610612737,ATL,96,away,1610612756,PHX,69,27,-27,1610612737,1610612756,"(201952, 203488, 2594, 201960, 201143)","(201148, 202339, 200782, 202693, 202694)",False
1150,0021401155,home,1610612748,MIA,105,away,1610612766,CHA,100,-5,5,1610612748,1610612766,"(2736, 201609, 202355, 2548, 2617)","(202689, 203106, 101107, 202687, 201945)",True
1151,0021401156,home,1610612740,NOP,103,away,1610612744,GSW,100,-3,3,1610612740,1610612744,"(201600, 201569, 201936, 202347, 203076)","(201939, 101106, 202691, 203084, 203110)",True
1152,0021401157,home,1610612760,OKC,88,away,1610612759,SAS,113,-25,25,1610612760,1610612759,"(202713, 202683, 203500, 201566, 203079)","(2225, 1495, 201980, 203382, 202695)",False
1153,0021401159,home,1610612746,LAC,105,away,1610612747,LAL,100,5,-5,1610612746,1610612747,"(2440, 200755, 101108, 201933, 201599)","(203903, 202391, 204028, 202325, 203527)",False
1154,0021401160,home,1610612766,CHA,74,away,1610612761,TOR,92,-18,18,1610612766,1610612761,"(202689, 203106, 101107, 202687, 201945)","(201946, 203082, 202349, 201942, 202685)",False
1155,0021401161,home,1610612753,ORL,105,away,1610612741,CHI,103,-2,2,1610612753,1610612741,"(202696, 203473, 203506, 202699, 203901)","(2200, 2399, 201149, 202710, 201565)",True
1156,0021401162,home,1610612755,PHI,90,away,1610612764,WAS,119,-29,29,1610612755,1610612764,"(203496, 203457, 203128, 203924, 202397)","(2400, 101162, 201196, 1718, 203078)",False
1157,0021401163,home,1610612751,BKN,111,away,1610612737,ATL,114,3,-3,1610612751,1610612737,"(201152, 203900, 101114, 201572, 2207)","(201952, 201960, 2594, 203488, 201143)",True
1158,0021401164,home,1610612765,DET,103,away,1610612738,BOS,113,10,-10,1610612765,1610612738,"(202704, 202328, 203083, 203484, 2406)","(203092, 101138, 202323, 202340, 203935)",True
1159,0021401165,home,1610612752,NYK,86,away,1610612754,IND,102,16,-16,1610612752,1610612754,"(200745, 202498, 203499, 200811, 204038)","(201579, 2561, 201588, 101139, 203524)",True
1160,0021401166,home,1610612763,MEM,110,away,1610612740,NOP,74,36,-36,1610612763,1610612740,"(2216, 201584, 201144, 201188, 201145)","(201600, 201569, 201936, 202347, 203076)",False
1161,0021401167,home,1610612749,MIL,99,away,1610612739,CLE,104,5,-5,1610612749,1610612739,"(201162, 2585, 203114, 101141, 203487)","(2544, 202681, 2747, 202389, 201567)",True
1162,0021401168,home,1610612759,SAS,110,away,1610612745,HOU,98,-12,12,1610612759,1610612745,"(2225, 1495, 201980, 203382, 202695)","(2730, 1891, 2772, 203093, 201935)",True
1163,0021401169,home,1610612743,DEN,119,away,1610612747,LAL,101,18,-18,1610612743,1610612747,"(201568, 201163, 201951, 202702, 200751)","(203913, 203903, 204028, 202325, 203527)",False
1164,0021401170,home,1610612762,UTA,103,away,1610612758,SAC,91,-12,12,1610612762,1610612758,"(203497, 202330, 202324, 203957, 203918)","(201956, 201171, 203492, 201574, 203463)",True
1165,0021401171,home,1610612742,DAL,107,away,1610612756,PHX,104,3,-3,1610612742,1610612756,"(101145, 2210, 1717, 200765, 2199)","(201148, 202339, 200782, 202693, 202694)",False
1166,0021401172,home,1610612757,POR,116,away,1610612750,MIN,91,-25,25,1610612757,1610612750,"(201577, 200746, 201587, 203081, 201167)","(203120, 203952, 2755, 203940, 203897)",True
1167,0021401173,home,1610612748,MIA,78,away,1610612741,CHI,89,11,-11,1610612748,1610612741,"(2736, 201609, 202355, 2548, 2617)","(2200, 2399, 201149, 201565, 203503)",True
1168,0021401174,home,1610612744,GSW,116,away,1610612757,POR,105,11,-11,1610612744,1610612757,"(201939, 101106, 202691, 203084, 203110)","(201577, 200746, 201587, 203081, 201167)",False
1169,0021401175,home,1610612753,ORL,99,away,1610612761,TOR,101,-2,2,1610612753,1610612761,"(202696, 203473, 203506, 202699, 203901)","(200768, 203082, 201946, 202685, 201942)",False
1170,0021401176,home,1610612737,ATL,104,away,1610612766,CHA,80,24,-24,1610612737,1610612766,"(203488, 201952, 2594, 201960, 201143)","(202689, 203106, 101107, 202687, 201945)",False
1171,0021401177,home,1610612751,BKN,117,away,1610612764,WAS,80,37,-37,1610612751,1610612764,"(201152, 203900, 101114, 201572, 2207)","(101162, 2403, 201196, 1718, 203078)",False
1172,0021401178,home,1610612739,CLE,90,away,1610612738,BOS,99,9,-9,1610612739,1610612738,"(2544, 203521, 2747, 202389, 201567)","(203092, 101138, 202323, 202340, 203935)",True
1173,0021401179,home,1610612765,DET,103,away,1610612754,IND,107,-4,4,1610612765,1610612754,"(202704, 202328, 203083, 203484, 2406)","(101139, 2561, 201588, 201579, 203524)",False
1174,0021401180,home,1610612752,NYK,91,away,1610612749,MIL,99,8,-8,1610612752,1610612749,"(203112, 202498, 202332, 203501, 204038)","(2585, 203114, 203507, 101141, 203487)",True
1175,0021401181,home,1610612745,HOU,103,away,1610612759,SAS,104,-1,1,1610612745,1610612759,"(2730, 1891, 2772, 203093, 201935)","(2225, 1495, 201980, 203382, 202695)",False
1176,0021401182,home,1610612740,NOP,90,away,1610612756,PHX,75,15,-15,1610612740,1610612756,"(201600, 201569, 201936, 202347, 203076)","(201148, 202339, 200782, 202693, 202694)",False
1177,0021401183,home,1610612760,OKC,116,away,1610612758,SAC,103,13,-13,1610612760,1610612758,"(203460, 202683, 203500, 201566, 203079)","(201956, 201171, 203492, 201574, 203463)",False
1178,0021401185,home,1610612762,UTA,88,away,1610612763,MEM,89,1,-1,1610612762,1610612763,"(203497, 202330, 202324, 203957, 203918)","(2216, 201584, 201188, 2757, 201145)",True
1179,0021401186,home,1610612747,LAL,106,away,1610612750,MIN,98,8,-8,1610612747,1610612750,"(203913, 203903, 204028, 202325, 203527)","(203120, 203952, 2755, 203940, 203897)",False
1180,0021401187,home,1610612753,ORL,79,away,1610612752,NYK,80,1,-1,1610612753,1610612752,"(202696, 203473, 203506, 202699, 203901)","(201160, 202498, 202332, 203501, 204038)",True
1181,0021401188,home,1610612748,MIA,104,away,1610612761,TOR,107,-3,3,1610612748,1610612761,"(2736, 201609, 202355, 2548, 2617)","(200768, 203082, 201946, 201942, 202685)",False
1182,0021401189,home,1610612741,CHI,114,away,1610612755,PHI,107,7,-7,1610612741,1610612755,"(2200, 2399, 201565, 202710, 201149)","(203128, 203496, 2202, 203960, 203924)",False
1183,0021401190,home,1610612746,LAC,94,away,1610612763,MEM,86,8,-8,1610612746,1610612763,"(2440, 200755, 101108, 201933, 201599)","(2216, 201584, 201188, 2757, 201145)",False
1184,0021401191,home,1610612757,POR,105,away,1610612762,UTA,111,-6,6,1610612757,1610612762,"(201577, 201587, 203468, 203086, 203081)","(202344, 203497, 204060, 203957, 203918)",False
1185,0021401192,home,1610612744,GSW,110,away,1610612750,MIN,101,9,-9,1610612744,1610612750,"(202691, 101106, 201939, 203084, 203110)","(203120, 203952, 2755, 203940, 203897)",False
1186,0021401193,home,1610612749,MIL,96,away,1610612751,BKN,73,-23,23,1610612749,1610612751,"(2585, 203114, 203507, 101141, 203487)","(201152, 203900, 101114, 201572, 2207)",True
1187,0021401194,home,1610612738,BOS,117,away,1610612739,CLE,78,39,-39,1610612738,1610612739,"(203092, 101138, 202323, 202340, 203935)","(203521, 1890, 202684, 202389, 202697)",False
1188,0021401195,home,1610612765,DET,116,away,1610612766,CHA,77,-39,39,1610612765,1610612766,"(202704, 202328, 203083, 203484, 2406)","(202689, 203106, 101107, 202687, 201945)",True
1189,0021401196,home,1610612743,DEN,122,away,1610612758,SAC,111,11,-11,1610612743,1610612758,"(201568, 201163, 201951, 202702, 200751)","(203492, 202682, 201956, 201574, 203463)",False
1190,0021401197,home,1610612754,IND,116,away,1610612760,OKC,104,12,-12,1610612754,1610612760,"(101139, 2561, 201579, 201588, 203524)","(203500, 202683, 203460, 201566, 203079)",False
1191,0021401198,home,1610612764,WAS,108,away,1610612737,ATL,99,-9,9,1610612764,1610612737,"(101162, 2403, 202322, 203078, 1718)","(203488, 203145, 203098, 1882, 203471)",True
1192,0021401199,home,1610612745,HOU,121,away,1610612740,NOP,114,7,-7,1610612745,1610612740,"(2730, 1891, 2772, 203093, 201935)","(201600, 201569, 201936, 202347, 203076)",False
1193,0021401200,home,1610612759,SAS,107,away,1610612756,PHX,91,-16,16,1610612759,1610612756,"(2225, 1495, 2564, 201980, 202695)","(203462, 202339, 200782, 202693, 202694)",True
1194,0021401201,home,1610612747,LAL,106,away,1610612742,DAL,120,14,-14,1610612747,1610612742,"(203913, 203903, 204028, 202325, 203527)","(101145, 2210, 1717, 200765, 2199)",True
1195,0021401202,home,1610612766,CHA,90,away,1610612745,HOU,100,-10,10,1610612766,1610612745,"(202689, 203106, 101107, 202687, 201945)","(201595, 1891, 2772, 203093, 201935)",False
1196,0021401203,home,1610612739,CLE,109,away,1610612765,DET,97,12,-12,1610612739,1610612765,"(2544, 202681, 2747, 202389, 201567)","(202704, 202328, 203083, 203484, 2406)",False
1197,0021401204,home,1610612755,PHI,97,away,1610612749,MIL,107,10,-10,1610612755,1610612749,"(203496, 203128, 203138, 203924, 202397)","(2585, 203114, 203507, 101141, 203487)",True
1198,0021401205,home,1610612737,ATL,108,away,1610612752,NYK,112,-4,4,1610612737,1610612752,"(201952, 203488, 2594, 201960, 201143)","(201160, 202498, 202332, 203501, 204038)",False
1199,0021401206,home,1610612751,BKN,86,away,1610612741,CHI,113,-27,27,1610612751,1610612741,"(201152, 203900, 101114, 201572, 2207)","(2200, 2399, 201565, 202710, 201959)",False
1200,0021401207,home,1610612748,MIA,100,away,1610612753,ORL,93,7,-7,1610612748,1610612753,"(2736, 201609, 202355, 2548, 2617)","(202696, 203506, 202699, 203932, 203901)",False
1201,0021401208,home,1610612750,MIN,88,away,1610612740,NOP,100,-12,12,1610612750,1610612740,"(203120, 203897, 201978, 203952, 203940)","(201600, 201569, 201936, 202347, 203076)",False
1202,0021401209,home,1610612760,OKC,101,away,1610612757,POR,90,11,-11,1610612760,1610612757,"(203500, 202683, 203460, 201566, 203079)","(203081, 201587, 203468, 203086, 201577)",False
1203,0021401210,home,1610612762,UTA,109,away,1610612742,DAL,92,-17,17,1610612762,1610612742,"(202344, 203497, 204060, 203957, 203918)","(2210, 101109, 2405, 200765, 101111)",True
1204,0021401211,home,1610612758,SAC,102,away,1610612747,LAL,92,-10,10,1610612758,1610612747,"(203492, 201171, 201956, 201574, 203463)","(203913, 203903, 204028, 201941, 203527)",True
1205,0021401212,home,1610612744,GSW,111,away,1610612763,MEM,107,4,-4,1610612744,1610612763,"(201939, 101106, 202691, 203084, 203110)","(2216, 201584, 201188, 2757, 201145)",False
1206,0021401213,home,1610612746,LAC,110,away,1610612743,DEN,103,-7,7,1610612746,1610612743,"(2440, 200755, 101108, 201933, 201599)","(203914, 201163, 203475, 202702, 200751)",True
1207,0021401214,home,1610612738,BOS,95,away,1610612761,TOR,93,2,-2,1610612738,1610612761,"(203092, 101138, 202323, 202340, 203935)","(200768, 203082, 202349, 201946, 202685)",False
1208,0021401215,home,1610612754,IND,99,away,1610612764,WAS,95,4,-4,1610612754,1610612764,"(101139, 2561, 201588, 201579, 203524)","(2400, 101162, 202322, 203078, 1718)",False
1209,0021401216,home,1610612756,PHX,101,away,1610612746,LAC,112,11,-11,1610612756,1610612746,"(202339, 200782, 202693, 203462, 203933)","(2440, 200755, 101108, 201933, 201599)",True
1210,0021401217,home,1610612741,CHI,91,away,1610612737,ATL,85,-6,6,1610612741,1610612737,"(2200, 2399, 201565, 202710, 201959)","(201952, 201960, 2594, 200794, 201143)",True
1211,0021401218,home,1610612742,DAL,114,away,1610612757,POR,98,16,-16,1610612742,1610612757,"(101145, 2210, 1717, 200765, 2199)","(201577, 200746, 203459, 203081, 202087)",False
1212,0021401219,home,1610612745,HOU,117,away,1610612762,UTA,91,26,-26,1610612745,1610612762,"(2730, 1891, 2772, 203093, 201935)","(203497, 204060, 202324, 203957, 203918)",False
1213,0021401220,home,1610612763,MEM,95,away,1610612754,IND,83,-12,12,1610612763,1610612754,"(2216, 201584, 201188, 2757, 201145)","(101139, 2561, 201579, 201588, 203524)",True
1214,0021401221,home,1610612749,MIL,100,away,1610612738,BOS,105,5,-5,1610612749,1610612738,"(2585, 203114, 203507, 101141, 203487)","(203540, 101138, 202323, 203092, 203935)",True
1215,0021401222,home,1610612750,MIN,113,away,1610612760,OKC,138,-25,25,1610612750,1610612760,"(203952, 203897, 2755, 203940, 202620)","(203500, 202683, 203460, 201566, 203079)",False
1216,0021401223,home,1610612740,NOP,108,away,1610612759,SAS,103,5,-5,1610612740,1610612759,"(201600, 201569, 201936, 202347, 203076)","(2225, 1495, 201980, 203382, 202695)",False
1217,0021401224,home,1610612751,BKN,101,away,1610612753,ORL,88,13,-13,1610612751,1610612753,"(201152, 203900, 101114, 201572, 2207)","(202696, 203506, 203932, 203901, 203094)",False
1218,0021401225,home,1610612739,CLE,113,away,1610612764,WAS,108,5,-5,1610612739,1610612764,"(202681, 2034, 2747, 202389, 201567)","(203490, 201196, 101162, 2446, 2743)",False
1219,0021401226,home,1610612752,NYK,90,away,1610612765,DET,112,22,-22,1610612752,1610612765,"(201160, 202498, 202332, 203501, 204038)","(202704, 202328, 203083, 203484, 2406)",True
1220,0021401227,home,1610612755,PHI,101,away,1610612748,MIA,105,4,-4,1610612755,1610612748,"(203496, 203960, 203922, 203156, 203924)","(203516, 201563, 201611, 204020, 204054)",True
1221,0021401228,home,1610612761,TOR,92,away,1610612766,CHA,87,-5,5,1610612761,1610612766,"(200768, 203082, 201946, 201942, 202685)","(202689, 203106, 101107, 202687, 201945)",True
1222,0021401229,home,1610612744,GSW,133,away,1610612743,DEN,126,-7,7,1610612744,1610612743,"(201939, 101106, 202691, 203084, 203110)","(201568, 203914, 201163, 203994, 201951)",True
1223,0021401230,home,1610612747,LAL,99,away,1610612758,SAC,122,-23,23,1610612747,1610612758,"(203913, 203505, 204028, 201941, 203527)","(201171, 203492, 203917, 201574, 203463)",False
